key	text	tooltip
#Loc;1;text/db/effects__core.loc		
effects_description_wh_main_effect_technology_economy_gdp_mod_subsistence_dwarfs	城镇序列收入产值：%+n%	true
effects_description_wh_main_effect_character_stat_enable_magic_attacks	Enables magical attacks	true
effects_description_wh_main_effect_tech_recruitment_cost_reduction_chaos_giants	Recruitment cost: %+n% for Chaos Giant units	true
effects_description_wh_main_effect_name_epithet_chs_beloved_lord	[HIDDEN] Adds the name "Beloved Lord"	true
effects_description_wh_main_effect_force_army_campaign_stance_ambush_hidden_dummy	Hidden until discovered or battle initiated	true
effects_description_wh_main_effect_agent_recruitment_cost_mod_wizard_greenskins	Hero recruitment cost: %+n% for Shamans	true
effects_description_wh_main_effect_economy_gdp_mod_all	Income from all buildings: %+n%	true
effects_description_wh_main_effect_agent_enable_recruitment_champion_bretonnia	Enables [[img:icon_hero]][[/img]]Hero recruitment: Paladin	true
effects_description_wh_dlc05_effect_melee_damage_factionwide	Weapon strength: %+n% for all units	true
effects_description_wh_main_effect_name_epithet_dwf_the_astute	[HIDDEN] Adds the name "the Astute"	true
effects_description_wh_main_effect_name_title_emp_reiksmarshal	Gives the character the title: "Reiksmarshal"	true
effects_description_wh_main_effect_ability_enable_skull_of_katam	Ability: "Skull of Katam"	true
effects_description_wh_main_effect_agent_action_success_chance_engineer	Hero action success chance: %+n% for Master Engineers	true
effects_description_wh_main_effect_name_epithet_chs_chosen_of_tzeentch	[HIDDEN] Adds the name "Chosen of Tzeentch"	true
effects_description_wh_dlc03_effect_enable_item_icons_of_villification	Item: Icons of Vilification	true
effects_description_wh_main_effect_name_epithet_dwf_shadow_lord	[HIDDEN] Adds the name "Shadow Lord"	true
effects_description_wh_dlc03_effect_magic_beasts_cooldown_flock_of_doom	Cooldown: %+n% to "Flock of Doom"	true
effects_description_wh_main_effect_ability_enable_shield_of_faith	Battle prayer: "Shield of Faith"	true
effects_description_wh_dlc05_effect_siege_engine_unlock_wef_siege_tower	Pre-siege: siege tower	true
effects_description_wh_dlc03_effect_magic_beasts_enable_the_amber_spear	Spell: "The Amber Spear"	true
effects_description_wh_dlc04_effect_melee_defence_increase_corpse_cart_mortis_engine	Melee defence: %+n for Corpse Cart and Mortis Engine units	true
effects_description_wh_dlc04_effect_magic_vampires_invocation_of_nehek_helman	Spell: "Invocation of Nehek"	true
effects_description_wh_main_effect_economy_gdp_mod_agriculture_farming	[Will be renamed]Wealth: %+n% from agricultural buildings	true
effects_description_wh_main_effect_name_epithet_dwf_the_scarred	[HIDDEN] Adds the name "the Scarred"	true
effects_description_wh_main_effect_technology_economy_gdp_mod_livestock_dwarfs	Income from Toolmakers: %+n%	true
effects_description_wh_dlc05_effect_enable_mount_elven_steed	Mount: Elven Steed	true
effects_description_wh_main_effect_siege_engine_number_emp_siege_tower	%n siege towers per siege item	true
effects_description_wh_main_effect_siege_engine_number_vmp_siege_tower	%n siege towers per siege item	true
effects_description_wh_main_effect_agent_recruitment_cost_mod_engineer	Hero recruitment cost: %+n% for Master Engineers	true
effects_description_wh_main_effect_tech_battle_morale_increase_skeletons	Leadership: %+n for Skeletal units	true
effects_description_wh_main_effect_force_unit_stat_morale_during_night	Leadership: %+n during lightning strike battles	true
effects_description_wh_main_effect_name_epithet_grn_the_astute	[HIDDEN] Adds the name "the Astute"	true
effects_description_wh_main_effect_force_all_campaign_sacking_income_factionwide	Income from sacking settlements: %+n%	true
effects_description_wh_dlc05_effect_building_recruitment_duration_all	Recruitment duration: %+n turn for all units	true
effects_description_wh_main_effect_force_ward_save_missile_fighting_wood_elves	Missile resistance: %n% when fighting against Wood Elves	true
effects_description_wh_main_effect_religion_conversion_chaos_events_bad	Chaos corruption: %+n	true
effects_description_wh_main_effect_name_epithet_dwf_the_fool_on_the_wall	[HIDDEN] Adds the name "the Fool on the Wall"	true
effects_description_wh_dlc03_effect_bloodlust_modifier_non_aggression	Bestial rage: %+n from non-aggression pacts	true
effects_description_wh_main_effect_religion_conversion_untainted_events	Reduction in [[img:icon_corruption_vmp]][[/img]]Vampiric and [[img:icon_corruption_chs]][[/img]]Chaos corruption: %+n	true
effects_description_wh_dlc05_effect_agent_cap_increase_champion	Branchwraith [[img:icon_hero]][[/img]]Hero capacity: %+n	true
effects_description_wh_main_effect_building_construction_cost_mod_infrastructure	Construction cost: %+n% for Infrastructure buildings	true
effects_description_wh_main_effect_magic_vampires_enable_gaze_of_nagash	Spell: "Gaze of Nagash"	true
effects_description_wh_main_effect_name_epithet_dwf_the_the_perceptive	[HIDDEN] Adds the name "the Perceptive"	true
effects_description_wh_main_effect_name_epithet_dwf_marshal_of_the_wall	[HIDDEN] Adds the name "Marshal of the Wall"	true
effects_description_wh_main_effect_agent_recruitment_xp_dignitary_vampire_counts	Hero recruit rank: %+n for Vampires	true
effects_description_wh_dlc03_effect_building_upkeep_reduction_chaos_warhounds	Upkeep: %+n% for Chaos Warhound units	true
effects_description_wh_main_effect_ability_enable_grand_hammer_of_sigmar	Battle prayer: "Grand Hammer of Sigmar"	true
effects_description_wh_main_effect_agent_cap_increase_dignitary_warrior_priest	Warrior Priest [[img:icon_hero]][[/img]]Hero capacity: %+n	true
effects_description_wh_dlc03_effect_agent_enable_recruitment_wizard_beastmen	Enables [[img:icon_hero]][[/img]]Hero recruitment: Bray-Shaman	true
effects_description_wh_main_effect_economy_gdp_mod_commerce_all	[Will be renamed]Wealth: %+n% from commercial buildings	true
effects_description_wh_main_effect_region_all_campaign_enable_disease_attrition	Plague causes unit attrition	true
effects_description_wh_main_effect_ability_enable_hellfire_sword	Ability: "Hellfire Sword"	true
effects_description_wh_main_effect_name_epithet_emp_beloved_lord	[HIDDEN] Adds the name "Beloved Lord"	true
effects_description_wh_main_effect_name_epithet_vmp_beloved_lord	[HIDDEN] Adds the name "Beloved Lord"	true
effects_description_wh_main_effect_agent_action_cost_mod_dignitary_vampire_counts	Hero action cost: %+n% for Vampires	true
effects_description_wh_main_effect_name_epithet_dwf_death-stalker	[HIDDEN] Adds the name "Death-stalker"	true
effects_description_wh_main_effect_building_vampiric_mercenary_replenishment_crypt_ghouls	do not translate	true
effects_description_wh_main_effect_force_army_battle_infantry_ranged_ammunition	Ammunition: %+n% for missile infantry units	true
effects_description_wh_main_effect_force_army_campaign_upkeep_land_in_foreign_territory	Upkeep: %+n% for land units when in foreign territory	true
effects_description_wh_main_effect_tech_unit_xp_levels_boar_wolf_spider_riders	Unit experience: %+n for Boar, Wolf and Spider Rider unit recruits	true
effects_description_wh_main_effect_ability_enable_grand_shield_of_faith	Battle prayer: "Grand Shield of Faith"	true
effects_description_wh_main_effect_agent_recruitment_xp_spy_greenskins	Hero recruit rank: %+n for Goblin Big Bosses	true
effects_description_wh_main_effect_name_epithet_vmp_the_revenant	[HIDDEN] Adds the name "the Revenant"	true
effects_description_wh_main_effect_commandment_dwarfs_high_kings_tribute_tax_mod	High King's Tribute commandment: additional %n% {{tr:icon_income}}tax rate	true
effects_description_wh_main_effect_force_navy_campaign_experience_base_ships_all	Unit experience: %+n for all ship recruits	true
effects_description_wh_dlc05_effect_tech_missile_damage_increase_waystalkers	Missile damage: %+n% for embedded Waystalker [[img:icon_hero]][[/img]]Heroes	true
effects_description_wh_main_effect_name_epithet_brt_shadow_lord	[HIDDEN] Adds the name "Shadow Lord"	true
effects_description_wh_main_effect_magic_lil_waaagh_enable_curse_of_da_bad_moon	Spell: "Curse of Da Bad Moon"	true
effects_description_wh_dlc04_effect_enable_mount_brothers_corpse_cart	Mount: The Brothers Ghorst Corpse Cart	true
effects_description_wh_main_effect_agent_recruitment_cost_mod_spy_vampire_counts	Hero recruitment cost: %+n% for Banshees	true
effects_description_wh_main_effect_magic_vampires_cooldown_vanhels_danse_macabre	Cooldown: %+n% to "Vanhel's Danse Macabre"	true
effects_description_wh_main_effect_tech_melee_damage_increase_dire_wolves	Weapon strength: %+n% for Dire Wolves units	true
effects_description_wh_main_effect_tech_unit_xp_levels_dwf_blackpowder_fire_units	Unit experience: %+n for Dwarf blackpowder and fire-based unit recruits	true
effects_description_wh_main_effect_force_army_battle_charge_bonus	Charge bonus: %+n%	true
effects_description_wh_main_effect_economy_gdp_mod_industry_horde	[Will be renamed]Wealth: %+n% from industrial buildings	true
effects_description_wh_main_effect_ability_enable_the_crown_of_domination	Passive ability: "The Crown of Domination"	true
effects_description_wh_main_effect_name_epithet_chs_the_bloody_butcher	[HIDDEN] Adds the name "the Bloody Butcher"	true
effects_description_wh_main_effect_tech_battle_morale_increase_empire_infantry	Leadership: %+n for Empire infantry units	true
effects_description_wh_main_effect_economy_gdp_culture	Income generated: %n	true
effects_description_wh_main_effect_siege_engine_unlock_dwf_siege_tower	Pre-siege: siege tower	true
effects_description_wh_main_faction_diplomacy_penalty_wood_elves	Diplomatic relations: %+n with Wood Elves	true
effects_description_wh_main_effect_name_epithet_vmp_the_flayer	[HIDDEN] Adds the name "the Flayer"	true
effects_description_wh_main_effect_force_unit_stat_morale_versus_chaos	Leadership: %+n when fighting against Chaos and Norsca	true
effects_description_wh_dlc04_effect_magic_death_cooldown_spirit_leech_strigoi	Cooldown: %+n% to "Spirit Leech"	true
effects_description_wh_main_effect_name_epithet_grn_the_shaman	[HIDDEN] Adds the name "the Shaman"	true
effects_description_wh_main_effect_name_epithet_chs_scourgeborn	[HIDDEN] Adds the name "Scourgeborn"	true
effects_description_wh_dlc03_effect_bonus_morale_fighting_against_middenheim	Leadership: %+n when fighting against Middenheim forces	true
effects_description_wh_main_effect_siege_engine_enable_chs_siege_tower	Siege construction: siege tower	true
effects_description_wh_main_effect_force_campaign_stance_begin_fatigued_4_tired	Vigour in battle: Tired	true
effects_description_wh_main_effect_upkeep_all_characters	[HIDDEN] Upkeep for all characters	true
effects_description_wh_main_effect_force_army_battle_gyrocopter_armour	Armour: %+n for Gyrocopter and Gyrobomber units	true
effects_description_wh_dlc04_effect_force_speed_increase_flagellants	Speed: %+n% for Flagellants units	true
effects_description_wh_main_effect_magic_big_waaagh_cooldown_brain_bursta	Cooldown: %+n% to "Brain Bursta"	true
effects_description_wh_main_effect_force_army_campaign_stance_replenishment_dummy	Enables replenishment	true
effects_description_wh_main_effect_name_epithet_chs_the_astute	[HIDDEN] Adds the name "the Astute"	true
effects_description_wh_main_effect_tech_missile_rate_of_fire_increase_quarreller	Reload time reduction: %+n% for Quarrellers units	true
effects_description_wh_main_effect_name_epithet_brt_marshal_of_the_wall	[HIDDEN] Adds the name "Marshal of the Wall"	true
effects_description_wh_main_effect_magic_big_waaagh_enable_foot_of_gork	Spell: "Foot of Gork"	true
effects_description_wh_dlc04_effect_name_dummy_ghorst	[HIDDEN] Adds the name "Ghorst" with priority so it cannot be overridden	true
effects_description_wh_main_effect_public_order_penalty_other_religions	[Will be renamed]{{tr:public_order}}: %+n% penalty due to presence of other religions	true
effects_description_wh_main_effect_character_stat_mod_ap_damage	Armour-piercing damage: %+n	true
effects_description_wh_dlc05_effect_ability_enable_corruptor_of_the_shadowgave	Passive Ability: "Corruptor of the Shadowgave"	true
effects_description_wh_dlc04_effect_ability_enable_the_carstein_ring	Ability: "The Carstein Ring"	true
effects_description_wh_main_effect_agent_action_enable_champion_assist_province	Action: [[col:yellow]]Inspire Populace[[/col]]	true
effects_description_wh_main_effect_enable_mount_imperial_griffon	Mount: Imperial Griffon	true
effects_description_wh_main_effect_name_epithet_dwf_the_stickler	[HIDDEN] Adds the name "the Stickler"	true
effects_description_wh_main_effect_tech_melee_defence_increase_dwarf_characters	Melee defence: %+n for [[img:icon_general]][[/img]]Lords and embedded [[img:icon_hero]][[/img]]Heroes	true
effects_description_wh_main_effect_ability_enable_earthing_rod	Ability: "Earthing Rod"	true
effects_description_wh_main_effect_building_vampiric_mercenary_replenishment_bat_swarms	do not translate	true
effects_description_wh_main_effect_tech_hitpoints_increase_wolf_riders	Armour: %+n for Wolf Rider units	true
effects_description_wh_main_effect_ability_enable_dark_fortune	Ability: "Dark Fortune"	true
effects_description_wh_main_effect_tech_recruitment_cost_reduction_varghulfs_vargheists	Recruitment cost: %+n% for Varghulf and Vargheists units	true
effects_description_wh_main_effect_magic_vampires_cooldown_gaze_of_nagash	Cooldown: %+n% to "Gaze of Nagash"	true
effects_description_wh_main_effect_force_army_campaign_recruitment_cost_artillery	Recruitment cost: %+n% for artillery	true
effects_description_wh_main_effect_name_epithet_brt_champion_of_the_melee	[HIDDEN] Adds the name "Champion of the Melee"	true
effects_description_wh_main_effect_enable_mount_nightmare	Mount: Nightmare	true
effects_description_wh_main_effect_agent_action_cost_mod_champion_vampire_counts	Hero action cost: %+n% for Wight Kings	true
effects_description_wh_main_effect_name_epithet_emp_arch_lector	[HIDDEN] Adds the name "Arch Lector"	true
effects_description_wh_dlc04_effect_enable_mount_terrorgheist	Mount: Terrorgheist	true
effects_description_wh_main_effect_siege_engine_enable_emp_battering_ram	Siege construction: battering ram	true
effects_description_wh_main_effect_skill_melee_attack_increase_vmp_tier_2	Melee attack: %+n for Grave Guard and Crypt Horrors units	true
effects_description_wh_main_effect_siege_engine_enable_dwf_battering_ram	Siege construction: battering ram	true
effects_description_wh_main_effect_siege_engine_enable_grn_battering_ram	Siege construction: battering ram	true
effects_description_wh_main_effect_skill_melee_attack_increase_vmp_tier_1	Melee attack: %+n for Zombies, Skeletons and Crypt Ghouls units	true
effects_description_wh_main_effect_siege_engine_enable_chs_battering_ram	Siege construction: battering ram	true
effects_description_wh_main_effect_name_epithet_grn_the_scarred	[HIDDEN] Adds the name "the Scarred"	true
effects_description_wh_main_effect_siege_engine_enable_brt_battering_ram	Siege construction: battering ram	true
effects_description_wh_main_effect_siege_engine_number_chs_siege_tower	%n siege towers per siege item	true
effects_description_wh_main_effect_name_epithet_brt_the_scarred	[HIDDEN] Adds the name "the Scarred"	true
effects_description_wh_main_effect_siege_engine_enable_vmp_battering_ram	Siege construction: battering ram	true
effects_description_wh_main_effect_unit_stat_army_all_shield_mod	Shield effectiveness: %+n%	true
effects_description_wh_main_effect_name_epithet_brt_the_astute	[HIDDEN] Adds the name "the Astute"	true
effects_description_wh_dlc04_effect_unit_xp_levels_corpse_cart_mortis_engine	Unit experience: %+n for Corpse Cart and Mortis Engine unit recruits	true
effects_description_wh_main_effect_ability_enable_rune_of_oath_and_steel	Ability: "Rune of Oath & Steel"	true
effects_description_wh_dlc03_effect_magic_wild_enable_devolve	Spell: "Devolve"	true
effects_description_wh_main_effect_tech_movement_speed_increase_zombies	Speed: %+n% for Zombies units	true
effects_description_wh_main_effect_economy_gdp_mod_agriculture_farming_vampires	Income from Repression buildings: %+n%	true
effects_description_wh_main_effect_name_epithet_brt_beloved_lord	[HIDDEN] Adds the name "Beloved Lord"	true
effects_description_wh_main_effect_agent_action_cost_mod_engineer	Hero action cost: %+n% for Master Engineers	true
effects_description_wh_main_effect_character_stat_mod_personal_aura_morale_effect	Character's aura leadership effect: %+n	true
effects_description_wh_dlc05_effect_agent_enable_recruitment_champion_woodelves	Enables [[img:icon_hero]][[/img]]Hero recruitment: Branchwraith	true
effects_description_wh_main_effect_enable_mount_deathclaw	Mount: Deathclaw	true
effects_description_wh_main_effect_magic_big_waaagh_cooldown_ere_we_go	Cooldown: %+n% to "'Ere We Go"	true
effects_description_wh_main_effect_name_epithet_brt_the_tyrant	[HIDDEN] Adds the name "the Tyrant"	true
effects_description_wh_main_effect_name_epithet_grn_lord_of_war	[HIDDEN] Adds the name "Lord of War"	true
effects_description_wh_main_effect_name_epithet_grn_lore-keeper	[HIDDEN] Adds the name "Lore-keeper"	true
effects_description_wh_main_effect_tech_melee_defence_increase_slayers	Melee defence: %+n for Slayers units	true
effects_description_wh_main_effect_name_epithet_brt_lore-keeper	[HIDDEN] Adds the name "Lore-keeper"	true
effects_description_wh_main_effect_name_epithet_dwf_clan-friend	[HIDDEN] Adds the name "Clan-friend"	true
effects_description_wh_main_effect_name_epithet_brt_lord_of_war	[HIDDEN] Adds the name "Lord of War"	true
effects_description_wh_dlc05_tech_diplomacy_bonus_greenskins	Diplomatic relations: %+n with Greenskin Tribes	true
effects_description_wh_main_effect_building_vampiric_mercenary_replenishment_vargheist	do not translate	true
effects_description_wh_main_effect_economy_gdp_mod_subsistence	Income from cities: %+n%	true
effects_description_wh_main_effect_name_epithet_emp_lord_of_lies	[HIDDEN] Adds the name "Lord of Lies"	true
effects_description_wh_main_effect_name_epithet_vmp_lord_of_lies	[HIDDEN] Adds the name "Lord of Lies"	true
effects_description_wh_main_effect_building_vampiric_mercenary_capacity_zombies	do not translate	true
effects_description_wh_main_effect_building_vampiric_mercenary_replenishment_hexwraiths	do not translate	true
effects_description_wh_main_effect_name_epithet_chs_the_sorcerer	[HIDDEN] Adds the name "the Sorcerer"	true
effects_description_wh_main_effect_force_army_battle_enemy_unit_morale	Enemy leadership: %+n	true
effects_description_wh_main_effect_name_dummy_ironfist	[HIDDEN] Adds the name "Ironfist" with priority so it cannot be overridden	true
effects_description_wh_main_effect_name_epithet_dwf_night_lord	[HIDDEN] Adds the name "Night Lord"	true
effects_description_wh_main_effect_name_epithet_brt_master_of_the_court	[HIDDEN] Adds the name "Master of the Court"	true
effects_description_wh_main_effect_magic_vampires_cooldown_curse_of_years	Cooldown: %+n% to "Curse of Years"	true
effects_description_wh_main_effect_building_vampiric_mercenary_capacity_black_knights_0	do not translate	true
effects_description_wh_main_effect_building_vampiric_mercenary_capacity_black_knights_1	do not translate	true
effects_description_wh_main_effect_tech_melee_defence_increase_vargheists	Melee defence: %+n for Vargheist units	true
effects_description_wh_main_effect_ability_enable_tormentor_sword	Ability: "Tormentor Sword"	true
effects_description_wh_main_effect_enable_mount_organ_gun	Artillery: Organ Gun	true
effects_description_wh_dlc03_effect_siege_engine_number_bst_siege_tower	%n siege towers per siege item	true
effects_description_wh_dlc03_effect_ability_enable_icon_of_vilification	Passive ability: "Icons of Vilification"	true
effects_description_wh_main_effect_magic_metal_cooldown_gehennas_golden_hounds	Cooldown: %+n% to "Gehenna's Golden Hounds"	true
effects_description_wh_main_effect_name_epithet_vmp_man-slayer	[HIDDEN] Adds the name "Man-slayer"	true
effects_description_wh_dlc05_effect_ability_enable_hawks_talon	Ability: "Hawk's Talon"	true
effects_description_wh_main_effect_agent_action_dignitary_hinder_province_buff	[[col:yellow]]Inhibit[[/col]] action: Growth is modified by an additional %n	true
effects_description_wh_main_effect_tech_recruitment_cost_reduction_chaos_spawn	Recruitment cost: %+n% for Chaos Spawn units	true
effects_description_wh_main_effect_name_epithet_emp_the_brawler	[HIDDEN] Adds the name "the Brawler"	true
effects_description_wh_main_effect_name_epithet_chs_the_mawkish	[HIDDEN] Adds the name "the Mawkish"	true
effects_description_wh_dlc03_effect_magic_wild_enable_mantle_of_ghorok	Spell: "Mantle of Ghorok"	true
effects_description_wh_main_effect_tech_missile_rate_of_fire_rock_lobber	Reload time reduction: %+n% for Goblin Rock Lobber units	true
effects_description_wh_main_effect_force_army_battle_unit_morale_during_ambushes_desert	Leadership: %+n during desert ambushes	true
effects_description_wh_main_effect_agent_action_runesmith_assist_province_buff	[[col:yellow]]Runic Seal[[/col]] action: Enemy [[img:icon_hero]][[/img]]Hero success chance is modified by an additional %n%	true
effects_description_wh_main_effect_name_epithet_emp_the_prophet	[HIDDEN] Adds the name "the Prophet"	true
effects_description_wh_main_effect_name_epithet_vmp_the_prophet	[HIDDEN] Adds the name "the Prophet"	true
effects_description_wh_main_effect_name_epithet_brt_favoured_of_the_gods	[HIDDEN] Adds the name "Favoured of the Gods"	true
effects_description_wh_main_effect_agent_failure_chance_critical	Chance of being wounded after failure: %+n%	true
effects_description_wh_main_effect_force_all_campaign_replenishment_rate	Casualty replenishment rate: %+n%	true
effects_description_wh_dlc05_effect_tech_upkeep_reduction_wef_infantry_calvary	Upkeep: %+n% for Elf infantry and cavalry units	true
effects_description_wh_main_effect_tech_melee_damage_increase_varghulfs	Weapon strength: %+n% for Varghulf units	true
effects_description_wh_main_effect_name_epithet_vmp_spy-master	[HIDDEN] Adds the name "Spy-Master"	true
effects_description_wh_main_effect_name_epithet_chs_the_tyrant	[HIDDEN] Adds the name "the Tyrant"	true
effects_description_wh_main_effect_name_epithet_emp_the_appeaser	[HIDDEN] Adds the name "the Appeaser"	true
effects_description_wh_main_effect_name_epithet_vmp_the_appeaser	[HIDDEN] Adds the name "the Appeaser"	true
effects_description_wh_main_effect_military_force_winds_of_magic_depletion_mod_character_enemy	Enemy Winds of Magic power reserve: %+n	true
effects_description_wh_main_effect_name_epithet_chs_the_despised	[HIDDEN] Adds the name "the Despised"	true
effects_description_wh_main_effect_agent_action_enable_champion_hinder_character	Action: [[col:yellow]]Assassinate[[/col]]	true
effects_description_wh_main_effect_name_epithet_emp_night_lord	[HIDDEN] Adds the name "Night Lord"	true
effects_description_wh_dlc03_effect_building_upkeep_reduction_ungors	Upkeep: %+n% for Ungor units	true
effects_description_wh_main_effect_tech_movement_speed_infantry	Speed: %+n% for infantry units	true
effects_description_wh_main_effect_agent_action_enable_champion_hinder_army_horde	Action: [[col:yellow]]Demoralise Army[[/col]]	true
effects_description_wh_main_effect_building_upkeep_reduction_chaos_hounds	Upkeep: %+n% for Chaos Hound units	true
effects_description_wh_main_effect_force_army_battle_cavalry_charge_bonus	Charge bonus: %+n% for cavalry units	true
effects_description_wh_main_effect_magic_big_waaagh_cooldown_foot_of_gork	Cooldown: %+n% to "Foot of Gork"	true
effects_description_wh_main_effect_agent_action_enable_engineer_assist_province	Action: [[col:yellow]]Knuckle Down[[/col]]	true
effects_description_wh_main_effect_siege_engine_unlock_brt_battering_ram	Pre-siege: battering ram	true
effects_description_wh_main_effect_agent_recruitment_xp_champion_empire	Hero recruit rank: %+n for Empire Captains	true
effects_description_wh_main_effect_siege_engine_unlock_chs_battering_ram	Pre-siege: battering ram	true
effects_description_wh_main_effect_siege_engine_unlock_dwf_battering_ram	Pre-siege: battering ram	true
effects_description_wh_main_effect_siege_engine_unlock_emp_battering_ram	Pre-siege: battering ram	true
effects_description_wh_main_effect_force_army_battle_unit_morale_during_ambushes_forest	Leadership: %+n during forest ambushes	true
effects_description_wh_main_effect_siege_engine_unlock_grn_battering_ram	Pre-siege: battering ram	true
effects_description_wh_main_effect_name_epithet_emp_the_saviour	[HIDDEN] Adds the name "the Saviour"	true
effects_description_wh_main_effect_name_epithet_vmp_the_saviour	[HIDDEN] Adds the name "the Saviour"	true
effects_description_wh_main_effect_name_epithet_brt_keeper_of_the_dead	[HIDDEN] Adds the name "Keeper of the Dead"	true
effects_description_wh_main_effect_siege_engine_unlock_vmp_battering_ram	Pre-siege: battering ram	true
effects_description_wh_dlc05_effect_tech_melee_damage_increase_wef_treespirit	Weapon strength: %+n% for forest spirit units	true
effects_description_wh_main_effect_name_epithet_dwf_dark-bringer	[HIDDEN] Adds the name "Dark-bringer"	true
effects_description_wh_main_effect_force_army_campaign_experience_base_infantry	Unit experience: %+n for infantry unit recruits	true
effects_description_wh_main_effect_economy_gdp_mod_commerce_sea	Income from Ports: %+n%	true
effects_description_wh_main_effect_name_epithet_chs_the_appeaser	[HIDDEN] Adds the name "the Appeaser"	true
effects_description_wh_main_effect_name_epithet_emp_the_despised	[HIDDEN] Adds the name "the Despised"	true
effects_description_wh_main_effect_name_epithet_vmp_the_despised	[HIDDEN] Adds the name "the Despised"	true
effects_description_wh_main_effect_technology_economy_gdp_mod_manufacture_dwarfs	Income from Salt Mines and Dyemakers: %+n%	true
effects_description_wh_main_effect_name_epithet_grn_nurgles_ally	[HIDDEN] Adds the name "Nurgle's Ally"	true
effects_description_wh_main_effect_magic_big_waaagh_enable_brain_bursta	Spell: "Brain Bursta"	true
effects_description_wh_main_effect_tech_recruitment_cost_reduction_ironbreakers	Recruitment cost: %+n% for Ironbreakers units	true
effects_description_wh_main_effect_name_epithet_grn_the_fool_on_the_wall	[HIDDEN] Adds the name "the Fool on the Wall"	true
effects_description_wh_main_effect_character_stat_enable_poison_attacks_hidden	Enables Poison Attacks	true
effects_description_wh_main_effect_agent_action_runesmith_hinder_settlement_buff	[[col:yellow]]Damage Settlement[[/col]] action: Additional %n% damage caused	true
effects_description_wh_main_effect_religion_conversion_chaos_technologies	Chaos corruption: %+n	true
effects_description_wh_main_effect_character_stat_add_ap_damage_fell_bats	Armour-piercing damage: %+n for Fell Bats	true
effects_description_wh_main_effect_tech_melee_defence_increase_knights_demigryphs	Melee defence: %+n for Empire Knights, Reiksguard, Knights of the Blazing Sun, and Demigryph units	true
effects_description_wh_main_effect_economy_gdp_mod_all_adjacent_provinces	Income from all buildings: %+n%	true
effects_description_wh_main_effect_name_epithet_grn_grand_shambla	[HIDDEN] Adds the name "Grand Shambla'"	true
effects_description_wh_dlc05_effect_tech_armour_increase_eternal_guards	Armour: %+n% for Eternal Guard units	true
effects_description_wh_main_effect_agent_recruitment_xp_wizard_greenskins	Hero recruit rank: %+n for Shamans	true
effects_description_wh_main_effect_force_navy_battle_artillery_ship_melee_defence	Melee defence: %+n for artillery ships	true
effects_description_wh_main_effect_agent_action_enable_wizard_hinder_army	Action: [[col:yellow]]Assault Unit[[/col]]	true
effects_description_wh_dlc03_effect_siege_engine_enable_bst_siege_tower	Siege construction: siege tower	true
effects_description_wh_main_effect_name_epithet_dwf_gore-master	[HIDDEN] Adds the name "Gore-master"	true
effects_description_wh_main_effect_name_epithet_dwf_rune_warden	[HIDDEN] Adds the name "Rune Warden"	true
effects_description_wh_main_effect_enable_mount_imperial_pegasus	Mount: Imperial Pegasus	true
effects_description_wh_main_effect_name_epithet_chs_keeper_of_the_dead	[HIDDEN] Adds the name "Keeper of the Dead"	true
effects_description_wh_main_effect_siege_engine_number_emp_battering_ram	%n battering rams per siege item	true
effects_description_wh_main_effect_siege_engine_number_dwf_battering_ram	%n battering rams per siege item	true
effects_description_wh_main_effect_siege_engine_number_grn_battering_ram	%n battering rams per siege item	true
effects_description_wh_main_effect_ability_enable_sword_of_unholy_power	Passive ability: "Sword of Unholy Power"	true
effects_description_wh_main_effect_siege_engine_number_chs_battering_ram	%n battering rams per siege item	true
effects_description_wh_main_effect_tech_upkeep_reduction_dragon_ogre_shaggoths	Upkeep: %+n% for Dragon Ogre Shaggoths units	true
effects_description_wh_main_effect_siege_engine_number_brt_battering_ram	%n battering rams per siege item	true
effects_description_wh_main_effect_building_vampiric_mercenary_replenishment_black_coach	do not translate	true
effects_description_wh_main_effect_name_epithet_dwf_wall-craven	[HIDDEN] Adds the name "Wall-craven"	true
effects_description_wh_main_effect_enable_mount_warhorse	Mount: Warhorse	true
effects_description_wh_main_effect_force_army_battle_flying_melee_attack	Melee attack: %+n for Vargheists and Terrorgheist units	true
effects_description_wh_main_effect_siege_engine_number_vmp_battering_ram	%n battering rams per siege item	true
effects_description_wh_main_effect_tech_melee_damage_increase_empire_greatswords	Weapon strength: %+n% for Empire units with greatswords	true
effects_description_wh_main_effect_tech_melee_damage_increase_greenskin_chariots	Weapon strength: %+n% for Greenskin Chariot units	true
effects_description_wh_dlc03_effect_melee_attack_increase_characters_beastmen	Melee attack: %+n for [[img:icon_general]][[/img]]Lords and embedded [[img:icon_hero]][[/img]]Heroes	true
effects_description_wh_main_effect_force_unit_stat_morale_night_goblins	Leadership: %+n for Night Goblin units	true
effects_description_wh_main_effect_name_epithet_grn_night_lord	[HIDDEN] Adds the name "Night Lord"	true
effects_description_wh_main_effect_agent_action_dignitary_hinder_settlement_buff	[[col:yellow]]Damage Building[[/col]] action: Additional %n% damage caused	true
effects_description_wh_main_effect_public_order_events	{{tr:public_order}}: %+n	true
effects_description_wh_dlc05_effect_agent_action_success_chance_spy_wood_elves	Hero action success chance: %+n% for Waystalkers	true
effects_description_wh_dlc05_effect_tech_melee_attack_increase_wef_treespirits	Melee attack: %+n for all forest spirit units	true
effects_description_wh_main_effect_ability_enable_the_mace_of_helsturm	Ability: "The Mace of Helstrum"	true
effects_description_wh_main_effect_occupation_decision_colonise_cost_zero	No colonisation cost	true
effects_description_wh_main_effect_textonly_walls	Adds walls to the settlement	true
effects_description_wh_main_effect_ability_enable_the_screaming_banner	Passive ability: "The Screaming Banner"	true
effects_description_wh_main_effect_name_epithet_vmp_god-speaker	[HIDDEN] Adds the name "God-speaker"	true
effects_description_wh_main_effect_name_epithet_emp_the_mawkish	[HIDDEN] Adds the name "the Mawkish"	true
effects_description_wh_main_effect_name_epithet_vmp_the_mawkish	[HIDDEN] Adds the name "the Mawkish"	true
effects_description_wh_dlc04_effect_upkeep_reduction_for_all_agents_not_shown	Upkeep for all generals	true
effects_description_wh_main_effect_name_epithet_dwf_keeper_of_the_dead	[HIDDEN] Adds the name "Keeper of the Dead"	true
effects_description_wh_main_effect_tech_movement_speed_increase_goblins	Speed: %+n% for Goblin units	true
effects_description_wh_main_effect_force_all_campaign_captives	Captives captured after battle : %+n%	true
effects_description_wh_main_effect_public_order_tax_rate	{{tr:public_order}}: %+n	true
effects_description_wh_main_effect_ability_enable_get_on_wiv_it	Passive ability: "Get on Wiv it!"	true
effects_description_wh_main_effect_magic_lil_waaagh_cooldown_curse_of_da_bad_moon	Cooldown: %+n% to "Curse of Da Bad Moon"	true
effects_description_wh_main_effect_force_unit_stat_melee_attack_versus_greenskins	Melee attack: %+n when fighting against Greenskin Tribes	true
effects_description_wh_dlc04_effect_name_dummy_the_grim	[HIDDEN] Adds the name "the Grim" with priority so it cannot be overridden	true
effects_description_wh_main_effect_name_epithet_dwf_lord_of_war	[HIDDEN] Adds the name "Lord of War"	true
effects_description_wh_main_effect_name_epithet_brt_clan-friend	[HIDDEN] Adds the name "Clan-friend"	true
effects_description_wh_main_effect_name_epithet_grn_the_tyrant	[HIDDEN] Adds the name "the Tyrant"	true
effects_description_wh_main_effect_agent_action_cost_mod_champion_dwarfs	Hero action cost: %+n% for Thanes	true
effects_description_wh_main_effect_name_epithet_emp_keeper_of_the_dead	[HIDDEN] Adds the name "Keeper of the Dead"	true
effects_description_wh_main_effect_name_epithet_emp_favoured_of_the_gods	[HIDDEN] Adds the name "Favoured of the Gods"	true
effects_description_wh_main_effect_name_epithet_vmp_favoured_of_the_gods	[HIDDEN] Adds the name "Favoured of the Gods"	true
effects_description_wh_main_effect_tech_unit_xp_levels_bigun_black_orcs	Unit experience: %+n for Big 'Uns and Black Orc recruits	true
effects_description_wh_dlc05_effect_dummy_enable_office_ancient_of_delliandra	Unlocks the "Ancient of Delliandra" position within the Gathering of the Ancients	true
effects_description_wh_main_effect_name_epithet_dwf_champion_of_the_poor	[HIDDEN] Adds the name "Champion of the Poor"	true
effects_description_wh_main_effect_name_epithet_grn_clan-friend	[HIDDEN] Adds the name "Clan-friend"	true
effects_description_wh_main_effect_name_epithet_brt_the_appeaser	[HIDDEN] Adds the name "the Appeaser"	true
effects_description_wh_dlc03_effect_ability_disable_call_to_violence	Replaces: "Call of Violence"	true
effects_description_wh_main_effect_agent_action_success_chance_dignitary_vampire_counts	Hero action success chance: %+n% for Vampires	true
effects_description_wh_main_effect_name_epithet_dwf_master_of_the_court	[HIDDEN] Adds the name "Master of the Court"	true
effects_description_wh_main_effect_force_unit_stat_morale_chaos	Leadership: %+n for Chaos units	true
effects_description_wh_main_effect_magic_vampires_enable_curse_of_years	Spell: "Curse of Years"	true
effects_description_wh_main_effect_name_epithet_dwf_the_linchpin	[HIDDEN] Adds the name "the Linchpin"	true
effects_description_wh_dlc03_effect_magic_beasts_enable_the_curse_of_anraheir	Spell: "The Curse of Anraheir"	true
effects_description_wh_dlc05_effect_tech_upkeep_reduction_great_eagles	Upkeep: %+n% for Great Eagle units	true
effects_description_wh_dlc05_effect_magic_life_enable_flesh_to_stone	Spell: "Flesh to Stone"	true
effects_description_wh_dlc05_effect_tech_battle_morale_increase_animals	Leadership: %+n for Sisters of the Thorn, Wild Riders, Glade Riders, Hawk Riders, Great Eagle and Forest Dragon units	true
effects_description_wh_main_effect_name_epithet_dwf_the_tyrant	[HIDDEN] Adds the name "the Tyrant"	true
effects_description_wh_dlc05_effect_enable_mount_forest_dragon	Mount: Forest Dragon	true
effects_description_wh_main_effect_agent_action_cost_mod	Hero action cost: %+n%	true
effects_description_wh_main_effect_name_epithet_brt_wall-craven	[HIDDEN] Adds the name "Wall-craven"	true
effects_description_wh_main_effect_battle_magic_lore_of_vampires_cooldown_rate	Cooldown: %+n% to Lore of Vampires spells	true
effects_description_wh_main_effect_name_epithet_grn_rula_and_top_shouta	[HIDDEN] Adds the name "Rula and Top Shouta "	true
effects_description_wh_main_effect_tech_unit_xp_levels_emp_horse_units	Unit experience: %+n for Empire horse cavalry units	true
effects_description_wh_main_effect_name_epithet_vmp_ole_weirdy	[HIDDEN] Adds the name "Ole Weirdy"	true
effects_description_wh_main_effect_name_epithet_chs_favoured_of_the_gods	[HIDDEN] Adds the name "Favoured of the Gods"	true
effects_description_wh_dlc05_effect_magic_life_cooldown_flesh_to_stone	Cooldown: %+n% to "Flesh to Stone"	true
effects_description_wh_main_effect_name_epithet_brt_gore-master	[HIDDEN] Adds the name "Gore-master"	true
effects_description_wh_main_effect_tech_armour_increase_trolls	Armour: %+n for Trolls units	true
effects_description_wh_main_effect_agent_recruitment_cost_mod_dignitary_vampire_counts	Hero recruitment cost: %+n% for Vampires	true
effects_description_wh_main_effect_name_epithet_grn_wall-craven	[HIDDEN] Adds the name "Wall-craven"	true
effects_description_wh_main_effect_name_epithet_brt_the_despised	[HIDDEN] Adds the name "the Despised"	true
effects_description_wh_dlc03_effect_charge_for_ungors	Charge bonus: %+n for Ungor units	true
effects_description_wh_main_effect_tech_upkeep_reduction_battle_wizards	Upkeep: %+n% for Battle Wizard [[img:icon_hero]][[/img]]Heroes	true
effects_description_wh_main_effect_name_epithet_brt_night_lord	[HIDDEN] Adds the name "Night Lord"	true
effects_description_wh_dlc05_effect_tech_melee_defence_increase_spellsingers	Melee defence: %+n for embedded Spellsinger [[img:icon_hero]][[/img]]Heroes	true
effects_description_wh_main_effect_force_unit_stat_melee_damage_attacking	Weapon strength: %+n% (when attacking)	true
effects_description_wh_dlc05_effect_tech_battle_morale_increase_trees	Leadership: %+n for Dryad, Tree Kin and Treeman units	true
effects_description_wh_main_effect_force_navy_battle_assault_ship_melee_defence	Melee defence: %+n for melee ships	true
effects_description_wh_main_effect_name_epithet_vmp_the_looter	[HIDDEN] Adds the name "the Looter"	true
effects_description_wh_main_effect_name_epithet_grn_keeper_of_the_dead	[HIDDEN] Adds the name "Keeper of the Dead"	true
effects_description_wh_main_effect_name_epithet_chs_the_saviour	[HIDDEN] Adds the name "the Saviour"	true
effects_description_wh_dlc03_best_cygor_ammo	Ammunition: %+n% for Cygor Units	true
effects_description_wh_main_effect_general_ability_mod_cooldown_magical_animus	Cooldown: %+n% to "Magical Animus"	true
effects_description_wh_main_effect_name_epithet_emp_the_tyrant	[HIDDEN] Adds the name "the Tyrant"	true
effects_description_wh_main_effect_agent_recruitment_xp_engineer	Hero recruit rank: %+n for Master Engineers	true
effects_description_wh_main_effect_name_epithet_grn_the_sneaky	[HIDDEN] Adds the name "the Sneaky"	true
effects_description_wh_main_effect_force_unit_stat_morale_dummy	Leadership: %+n	true
effects_description_wh_main_effect_force_army_campaign_experience_infantry_spear	Unit experience: %+n for spear infantry recruits	true
effects_description_wh_main_faction_xp_increase_generals	Lord recruit rank: %+n	true
effects_description_wh_main_effect_name_epithet_vmp_master_of_traitors	[HIDDEN] Adds the name "Master of Traitors"	true
effects_description_wh_main_effect_name_epithet_chs_night_lord	[HIDDEN] Adds the name "Night Lord"	true
effects_description_wh_main_effect_force_navy_battle_melee_attack_when_escorting	Melee attack: %+n% when escorting transports	true
effects_description_wh_main_effect_force_unit_stat_morale_versus_rebels	Leadership: %+n versus rebels	true
effects_description_wh_dlc05_effect_tech_melee_attack_increase_treemen	Melee attack: %+n for Treemen units	true
effects_description_wh_dlc03_effect_ability_enable_the_brass_cleaver	Passive ability: "The Brass Cleaver"	true
effects_description_wh_main_effect_economy_gdp_mod_culture_horde	[Will be renamed]Wealth: %+n% from cultural buildings	true
effects_description_wh_main_effect_tech_missile_rate_of_fire_increase_chaos_hellcannon	Reload time reduction: %+n% for Hellcannon units	true
effects_description_wh_main_effect_tech_unit_xp_levels_black_coach_blood_knights	Unit experience: %+n for Black Coach, Corpse Cart, Mortis Engine, and Blood Knight unit recruits	true
effects_description_wh_dlc04_effect_force_all_campaign_sacking_loot_razing_income_dummy	Income from sacking and looting settlements: %+n%	true
effects_description_wh_main_effect_ability_disable_magical_animus	Replaces "Magical Animus"	true
effects_description_wh_main_effect_religion_conversion_untainted	Reduction in [[img:icon_corruption_vmp]][[/img]]Vampiric and [[img:icon_corruption_chs]][[/img]]Chaos corruption: %+n	true
effects_description_wh_dlc05_effect_magic_life_cooldown_shield_of_thorns_branchwraith	Cooldown: %+n% to "Shield of Thorns"	true
effects_description_wh_main_effect_name_title_emp_emperor_dummy	Gives the character the title: "Emperor"	true
effects_description_wh_dlc05_effect_dummy_enable_office_ancient_of_talrennic	Unlocks the "Ancient of Talrennic" position within the Gathering of the Ancients	true
effects_description_wh_main_effect_agent_enable_recruitment_wizard_teb	Enables [[img:icon_hero]][[/img]]Hero recruitment: Bright Wizard	true
effects_description_wh_main_effect_character_build_unit_killer	Unit killer: Skill selections have made this character more effective at slaying enemy units.	true
effects_description_wh_main_effect_unit_equipment_armour_silver	[Will be renamed]Armour smithing II: %+n armour for all unit recruits	true
effects_description_wh_main_effect_force_army_campaign_experience_base_empire_infantry	Unit experience: %+n for Empire infantry unit recruits	true
effects_description_wh_main_effect_ability_enable_waaagh	Ability: "Waaagh!"	true
effects_description_wh_main_effect_force_army_campaign_recruitment_cost_ranged_infantry	Recruitment cost: %+n% for missile infantry units	true
effects_description_wh_main_effect_force_army_campaign_siege_attack_holdout_time	Enemy siege holdout time: %+n	true
effects_description_wh_main_effect_region_enable_vampire_territory_attrition_bad	Enables [[img:icon_attrition]][[/img]]attrition for mortal armies	true
effects_description_wh_dlc05_effect_magic_shadow_the_withering	Spell: "The Withering"	true
effects_description_wh_main_effect_religion_osmosis_chaos	Chaos corruption in adjacent provinces: %+n	true
effects_description_wh_main_effect_name_epithet_dwf_valayas_thane	[HIDDEN] Adds the name "Valaya's Thane"	true
effects_description_wh_main_effect_tech_melee_damage_increase_dwarf_characters	Weapon strength: %+n% for [[img:icon_general]][[/img]]Lords and embedded [[img:icon_hero]][[/img]]Heroes	true
effects_description_wh_main_effect_magic_heavens_enable_chain_lightning	Spell: "Chain Lightning"	true
effects_description_wh_dlc05_effect_treeking_damage_reduction	Ward save: %n% for Tree Kin units	true
effects_description_wh_main_effect_skill_charge_bonus_increase_emp_tier_2	Charge bonus: %+n% for Greatswords, Empire Knights, Knights of the Blazing Sun, and Reiksguard units	true
effects_description_wh_main_effect_tech_hitpoints_increase_boyz	Armour: %+n for Orc infantry units	true
effects_description_wh_main_effect_unit_recruitment_points_naval	Navy recruitment capacity: %+n	true
effects_description_wh_main_effect_ability_enable_charmed_shield	Ability: "Charmed Shield"	true
effects_description_wh_main_effect_tech_unit_xp_levels_reiksguard	Unit experience: %+n for Reiksguard unit recruits	true
effects_description_wh_main_effect_ability_enable_featherfoe_torc	Passive ability: "Featherfoe Torc"	true
effects_description_wh_main_effect_agent_action_engineer_assist_army_buff	[[col:yellow]]Heavy Lifting[[/col]] action: Movement range is increased by an additional %n%	true
effects_description_wh_main_effect_agent_action_cost_mod_wizard_bretonnia	Hero action cost: %+n% for Damsels	true
effects_description_wh_main_effect_name_epithet_brt_the_combatant	[HIDDEN] Adds the name "the Combatant"	true
effects_description_wh_main_effect_agent_action_spy_assist_province_buff	[[col:yellow]]Scout[[/col]] action: Enemy [[img:icon_hero]][[/img]]Hero success chance is modified by an additional %n%	true
effects_description_wh_main_effect_force_army_campaign_experience_base_slayers	Unit experience: %+n for Slayers unit recruits	true
effects_description_wh_main_effect_force_army_battle_unit_morale_siege_defence	Leadership: %+n when under siege	true
effects_description_wh_main_effect_force_army_campaign_recruitment_cost_cavalry	Recruitment cost: %+n% for cavalry units	true
effects_description_wh_dlc04_effect_magic_vampires_cooldown_raise_dead_strigoi	Cooldown: %+n% to "Command of the Unliving"	true
effects_description_wh_main_effect_tech_recruitment_cost_reduction_dire_wolves	Recruitment cost: %+n% for Dire Wolves units	true
effects_description_wh_dlc03_effect_unit_enable_attribute_unbreakable	Attribute: Unbreakable	true
effects_description_wh_main_effect_force_unit_stat_missile_firing_rate	Reload time reduction: %+n%	true
effects_description_wh_main_effect_tech_unit_xp_levels_graveguard_black_knights	Unit experience: %+n for Grave Guard and Black Knight unit recruits	true
effects_description_wh_dlc03_effect_force_army_campaign_stance_beastpaths_interception_dummy	Nearby hostile armies may intercept, meeting on the beast-path for battle.	true
effects_description_wh_main_effect_magic_light_cooldown_bironas_timewarp	Cooldown: %+n% to "Birona's Timewarp"	true
effects_description_wh_dlc03_effect_agent_action_success_chance_wizard_beastmen	Hero action success chance: %+n% for Bray-Shamans	true
effects_description_wh_main_effect_agent_action_success_chance_spy_vampire_counts	Hero action success chance: %+n% for Banshees	true
effects_description_wh_main_effect_ability_enable_master_rune_of_stromni_redbeard	Passive ability: "Master Rune of Stromni Redbeard"	true
effects_description_wh_main_effect_name_epithet_emp_the_enchanter	[HIDDEN] Adds the name "the Enchanter"	true
effects_description_wh_main_effect_tech_unit_xp_levels_greenskin_chariots	Unit experience: %+n for Greenskin Chariot unit recruits	true
effects_description_wh_main_effect_agent_recruitment_xp_champion_chaos	Hero recruit rank: %+n for Exalted Heroes	true
effects_description_wh_main_effect_province_food_shortage_public_order_happiness	{{tr:public_order}}: [[col:red]]%+n[[/col]]	true
effects_description_wh_main_effect_agent_action_cost_mod_wizard_vampire_counts	Hero action cost: %+n% for Necromancers	true
effects_description_wh_main_effect_skill_charge_bonus_increase_grn_tier_1	Charge bonus: %+n for Goblins, Night Goblins, Orc Boyz and Savage Orcs units	true
effects_description_wh_main_effect_skill_charge_bonus_increase_grn_tier_2	Charge bonus: %+n for Orc Big 'Uns, Savage Orc Big 'Uns and Black Orcs units	true
effects_description_wh_main_effect_magic_death_enable_the_purple_sun_of_xereus	Spell: "The Purple Sun of Xereus"	true
effects_description_wh_main_effect_force_army_battle_pistoliers_outriders_movement_speed	Speed: %+n% for Pistoliers and Outriders units	true
effects_description_wh_main_effect_force_army_battle_cavalry_ranged_ammunition	Ammunition: %+n% for missile cavalry	true
effects_description_wh_main_effect_magic_light_enable_banishment	Spell: "Banishment"	true
effects_description_wh_main_effect_tech_melee_defence_increase_dwarf_longbeards_hammerers_ironbreakers_slayers	Melee defence: %+n for Longbeards, Hammerers, Ironbreakers and Slayers units	true
effects_description_wh_main_effect_force_unit_stat_melee_defence	Melee defence: %+n	true
effects_description_wh_main_effect_agent_action_enable_wizard_hinder_settlement	Action: [[col:yellow]]Damage Building[[/col]]	true
effects_description_wh_dlc03_effect_tech_army_campaign_beastpath_evasion_chance	Evasion chance when using a beast-path: %+n%	true
effects_description_wh_main_effect_ability_enable_helm_of_discord	Ability: "Helm of Discord"	true
effects_description_wh_main_effect_tech_recruitment_cost_reduction_dwarf_warriors	Recruitment cost: %+n% for Dwarf Warriors units	true
effects_description_wh_main_effect_agent_cap_increase_spy_goblin_big_boss	Goblin Big Boss [[img:icon_hero]][[/img]]Hero capacity: %+n	true
effects_description_wh_main_effect_character_stat_mod_missile_attack_rate	Reload time reduction: %+n%	true
effects_description_wh_main_effect_ability_enable_ancestor_rune	Ability: "Ancestor Rune"	true
effects_description_wh_main_effect_agent_action_enable_champion_hinder_settlement_horde	Action: [[col:yellow]]Storm Garrison[[/col]]	true
effects_description_wh_main_effect_agent_action_outcome_parent_army_ap	Campaign movement range: %+n%	true
effects_description_wh_dlc05_effect_occupation_decision_colonise_cost_increase_hidden	No colonisation cost	true
effects_description_wh_main_effect_agent_enable_recruitment_spy_empire	Enables [[img:icon_hero]][[/img]]Hero recruitment: Witch Hunter	true
effects_description_wh_main_effect_tech_melee_defence_increase_fell_bats	Melee defence: %+n for Fell Bat units	true
effects_description_wh_dlc05_effect_tech_unit_xp_levels_eternal_guards	Unit experience: %+n for Eternal Guard unit recruits	true
effects_description_wh_dlc05_effect_amber_quest_events_dummy	Amber: %n	true
effects_description_wh_main_effect_ability_enable_ballistics_calibration	Ability: "Ballistics Calibration"	true
effects_description_wh_main_effect_technology_research_cost_mod_military	[Will be renamed]Research upkeep cost: %+n% for military developments	true
effects_description_wh_main_effect_force_artillery_campaign_replenishment_rate	Casualty replenishment rate: %+n% for artillery	true
effects_description_wh_main_effect_tech_unit_xp_levels_empire_artillery	Unit experience: %+n for Empire artillery recruits	true
effects_description_wh_main_effect_tech_recruitment_cost_reduction_forest_beasts	Recruitment cost: %+n% for all units recruited from the Forest building chain	true
effects_description_wh_dlc05_effect_orion_amber	Elite forest spirit units cost Amber to recruit	true
effects_description_wh_dlc04_effect_magic_vampires_vanhels_danse_macabre_helman	Spell: "Danse Macabre"	true
effects_description_wh_dlc05_effect_tech_melee_defence_increase_wef_treespirits_monsters_branchwraiths	Melee defence: %+n for forest spirit and flying monster units	true
effects_description_wh_main_effect_public_order_faction	{{tr:public_order}}: %+n	true
effects_description_wh_main_effect_agent_recruitment_xp_wizard_bretonnia	Hero recruit rank: %+n for Damsels	true
effects_description_wh_main_effect_force_all_campaign_stance_cannot_attack_dummy	[[col:red]]Battle initiation: Disabled[[/col]]	true
effects_description_wh_main_effect_agent_action_cost_mod_wizard_kislev	Hero action cost: %+n% for Celestial Wizards	true
effects_description_wh_dlc03_effect_agent_enable_recruitment_champion_beastmen	Enables [[img:icon_hero]][[/img]]Hero recruitment: Gorebull	true
effects_description_wh_main_effect_character_mod_ancillary_steal	Post battle chance of stealing a magic item: %+n%	true
effects_description_wh_dlc05_effect_force_army_battle_unit_ammo_siege_defence	Ammunition: %+n% when under siege	true
effects_description_wh_dlc03_effect_technology_research_points_hidden	[HIDDEN]	true
effects_description_wh_main_effect_religion_conversion_chaos_events_dummy	Chaos corruption: %+n	true
effects_description_wh_dlc03_effect_bloodlust_modifier_alliance	Bestial rage: %+n from alliance making	true
effects_description_wh_main_effect_building_vampiric_mercenary_capacity_vargheist	do not translate	true
effects_description_wh_main_effect_force_army_campaign_experience_base_war_beasts	Unit experience: %+n for war beast recruits	true
effects_description_wh_dlc03_effect_khazrak_stat_mod_personal_aura_size	Khazrak's aura size: %+n%	true
effects_description_wh_main_effect_name_epithet_vmp_the_doomsayer	[HIDDEN] Adds the name "the Doomsayer"	true
effects_description_wh_dlc05_effect_magic_shadow_cooldown_pit_of_shades	Cooldown: %+n% to "Pit of Shades"	true
effects_description_wh_main_effect_name_epithet_emp_the_doomsayer	[HIDDEN] Adds the name "the Doomsayer"	true
effects_description_wh_main_effect_force_navy_battle_unit_morale_when_escorting	Leadership: %+n when escorting transports	true
effects_description_wh_main_effect_force_army_campaign_experience_base_knights	Unit experience: %+n for Empire Knights, Reiksguard, Knights of the Blazing Sun, and Demigryph unit recruits	true
effects_description_wh_main_effect_agent_action_wizard_assist_army_buff	[[col:yellow]]Scouting[[/col]] action: Magic item drop chance is increased by an additional %n%	true
effects_description_wh_main_effect_hordebuilding_growth_events_faction	Horde Growth: %+n	true
effects_description_wh_main_effect_force_army_campaign_tunnelling_evasion_chance	Evasion chance when using the Underway: %+n%	true
effects_description_wh_main_effect_agent_action_enable_runesmith_assist_province	Action: [[col:yellow]]Runic Seal[[/col]]	true
effects_description_wh_dlc03_effect_tech_recruitment_cost_reduction_minotaurs	Recruitment cost: %+n% for Minotaur units	true
effects_description_wh_dlc05_effect_ability_enable_pray_of_anna_raema	Ability: "Prey of Anath Raema"	true
effects_description_wh_main_effect_tech_unit_xp_levels_hammerers	Unit experience: %+n for Hammerers unit recruits	true
effects_description_wh_main_effect_agent_action_enable_spy_hinder_army	Action: [[col:yellow]]Block Army[[/col]]	true
effects_description_wh_main_effect_tech_movement_speed_increase_chaos_warhounds	Speed: %+n% for Chaos Warhound units	true
effects_description_wh_dlc03_effect_magic_beasts_enable_flock_of_doom	Spell: "Flock of Doom"	true
effects_description_wh_main_effect_agent_action_champion_hinder_army_buff	[[col:yellow]]Assault Units[[/col]] action: Additional %n% casualties inflicted	true
effects_description_wh_main_effect_force_army_battle_infantry_spears_melee_attack	Melee attack: %+n for spear infantry units	true
effects_description_wh_main_effect_commandment_dwarfs_high_kings_tribute_tax_base	{{tr:tax_rate}}: %+n%	true
effects_description_wh_main_effect_agent_action_enable_runesmith_hinder_character	Action: [[col:yellow]]Assassinate[[/col]]	true
effects_description_wh_main_effect_agent_action_all_hinder_character_buff	[[col:yellow]]Assassinate[[/col]] action: Additional %n% chance of killing target	true
effects_description_wh_main_effect_province_growth_other	Growth: %+n	true
effects_description_wh_dlc03_effect_technology_research_points	Research rate: %+n%	true
effects_description_wh_main_effect_skill_charge_bonus_increase_chs_tier_2	Charge bonus: %+n for Chosen units	true
effects_description_wh_main_effect_force_army_battle_cavalry_fatigue_resistance	Vigour loss reduction for cavalry units	true
effects_description_wh_main_effect_skill_charge_bonus_increase_chs_tier_1	Charge bonus: %+n for Marauders, Chaos Warrior and Aspiring Champion units	true
effects_description_wh_main_effect_province_growth_taxes	Growth: %+n	true
effects_description_wh_main_effect_tech_melee_damage_increase_forsaken	Weapon strength: %+n% for Forsaken units	true
effects_description_wh_main_effect_enable_mount_barded_warhorse	Mount: Barded Warhorse	true
effects_description_wh_dlc05_effect_force_army_battle_unit_reload_speed_siege_defence	Reload time reduction: %+n% when under siege	true
effects_description_wh_main_effect_tech_recruitment_cost_reduction_pistoliers_outriders	Recruitment cost: %+n% for Pistoliers and Outriders units	true
effects_description_wh_main_effect_ability_enable_skull_wand_of_kaloth	Ability: "Skull Wand of Kaloth"	true
effects_description_wh_dlc05_effect_amber_quest_events_hidden	Amber: %n	true
effects_description_wh_main_effect_ability_enable_stand_your_ground_grn	Ability: "Stand Your Ground!"	true
effects_description_wh_dlc03_effect_spell_buff_dummy_for_accompany_lord	Reduces spell cooldowns	true
effects_description_wh_main_effect_agent_recruitment_cost_mod_wizard_bretonnia	Hero recruitment cost: %+n% for Damsels	true
effects_description_wh_main_effect_force_army_campaign_stance_growth_all_dummy	Growth: %+n in the raided province	true
effects_description_wh_dlc03_effect_magic_wild_enable_viletide	Spell: "Viletide"	true
effects_description_wh_main_effect_ambush_defence_success_chance_kholek	Gigantic Beast: %+n% ambush defence chance	true
effects_description_wh_main_effect_character_stat_enable_poison_attacks	Enables poison attacks	true
effects_description_wh_main_effect_name_epithet_vmp_the_count_of_beasts	[HIDDEN] Adds the name "the Count of Beasts"	true
effects_description_wh_dlc03_effect_magic_beasts_cooldown_the_curse_of_anraheir	Cooldown: %+n% to "The Curse of Anraheir"	true
effects_description_wh_dlc03_effect_ability_enable_chalice_of_dark_rain	Ability: "Chalice of Dark Rain"	true
effects_description_wh_main_effect_agent_action_enable_engineer_hinder_settlement	Action: [[col:yellow]]Damage Walls[[/col]]	true
effects_description_wh_dlc04_effect_character_stat_enable_helmans_blight_attacks_hidden	Enables blight attacks	true
effects_description_wh_main_effect_agent_enable_recruitment_wizard_empire	Enables [[img:icon_hero]][[/img]]Hero recruitment: Battle Wizard	true
effects_description_wh_dlc03_effect_force_all_campaign_replenishment_rate_horde	Casualty replenishment rate: %+n%	true
effects_description_wh_dlc03_effect_magic_wild_cooldown_savage_dominion	Cooldown: %+n% to "Savage Dominion"	true
effects_description_wh_main_effect_tech_unit_xp_levels_dwf_melee_infantry	Unit experience: %+n for Dwarf melee unit recruits	true
effects_description_wh_dlc03_effect_building_upkeep_reduction_centigors	Upkeep: %+n% for Centigor units	true
effects_description_wh_main_effect_agent_cap_increase_dignitary_vampire	Vampire [[img:icon_hero]][[/img]]Hero capacity: %+n	true
effects_description_wh_main_effect_hordebuilding_growth_stance	Horde Growth: %+n	true
effects_description_wh_main_effect_agent_action_success_chance_champion_empire	Hero action success chance: %+n% for Empire Captains	true
effects_description_wh_dlc03_effect_ability_enable_blood_lust	Ability: "Blood Lust"	true
effects_description_wh_main_effect_tech_missile_rate_of_fire_increase_doomdiver	Reload time reduction: %+n% for Doom Diver Catapult units	true
effects_description_wh_main_effect_magic_fire_enable_flame_storm	Spell: "Flame Storm"	true
effects_description_wh_main_effect_tech_hitpoints_increase_black_coach	Armour: %+n for Black Coach, Corpse Cart, and Mortis Engine units	true
effects_description_wh_main_effect_force_all_campaign_military_morale_factor_tax	Fightiness: %+n	true
effects_description_wh_dlc03_effect_ability_enable_banner_of_outrage	Passive ability: "Frenzy"	true
effects_description_wh_dlc05_effect_agent_enable_recruitment_wizard_woodelves	Enables [[img:icon_hero]][[/img]]Hero recruitment: Spellsinger	true
effects_description_wh_main_effect_tech_armour_increase_skeleton_warriors_spears	Armour: %+n for Skeleton Warriors and Skeleton Spearmen units	true
effects_description_wh_main_effect_magic_death_enable_soulblight	Spell: "Soulblight"	true
effects_description_wh_main_effect_force_unit_stat_morale_goblins	Leadership: %+n for Goblin units	true
effects_description_wh_dlc05_effect_tech_upkeep_reduction_waywatchers	Upkeep: %+n% for Waywatcher units	true
effects_description_wh_main_effect_tech_missile_rate_of_fire_increase_thunderer	Reload time reduction: %+n% for Thunderers units	true
effects_description_wh_main_effect_force_army_campaign_recruitment_cost_melee_infantry	Recruitment cost: %+n% for melee infantry units	true
effects_description_wh_main_effect_religion_conversion_chaos_bad	Chaos corruption: %+n	true
effects_description_wh_dlc05_effect_tech_armour_increase_wef_elf_units	Armour: %+n% for Elf infantry and cavalry units	true
effects_description_wh_main_effect_tech_unit_xp_levels_marauders	Unit experience: %+n for Marauder unit recruits	true
effects_description_wh_dlc03_effect_agent_recruitment_cost_mod_wizard_beastmen	Hero recruitment cost: %+n% for Bray-Shamans	true
effects_description_wh_main_effect_ability_enable_master_rune_of_courage	Ability: "Rune of Courage"	true
effects_description_wh_main_effect_tech_recruitment_cost_reduction_brt_bowmen_spearmen	Recruitment cost: %+n% for Bretonnian Archers and Spearmen recruits	true
effects_description_wh_main_effect_ability_enable_magical_animus	Ability: "Magical Animus"	true
effects_description_wh_main_effect_enable_mount_skeletal_steed	Mount: Skeletal Steed	true
effects_description_wh_main_effect_force_army_campaign_stance_tunnelling_movement_dummy	Traverse underground terrain that would normally be impassable	true
effects_description_wh_main_effect_agent_action_success_chance_wizard_greenskins	Hero action success chance: %+n% for Shamans	true
effects_description_wh_main_effect_magic_death_cooldown_the_purple_sun_of_xereus	Cooldown: %+n% to "The Purple Sun of Xereus"	true
effects_description_wh_main_effect_character_build_caster	Caster: Skill selections have made this character a highly effective spellcaster.	true
effects_description_wh_main_effect_force_unit_stat_morale	Leadership: %+n	true
effects_description_wh_main_effect_tech_movement_speed_increase_marauders	Speed: %+n% for Marauder units	true
effects_description_wh_main_effect_force_navy_battle_unit_morale_blockade_defence	Leadership: %+n when blockaded	true
effects_description_wh_dlc04_effect_ability_enable_unbreakable	[HIDDEN]	true
effects_description_wh_main_effect_name_epithet_dwf_hammer_of_the_sacred_anvil	[HIDDEN] Adds the name "Hammer of the Sacred Anvil"	true
effects_description_wh_dlc03_effect_force_army_battle_missile_damage	Missile damage: %+n% for all units	true
effects_description_wh_main_effect_agent_action_outcome_target_army_ap	Campaign movement range: %+n%	true
effects_description_wh_dlc03_effect_spell_buff_dummy_for_agent	[HIDDEN] Reduces the cooldown of spells	true
effects_description_wh_dlc03_effect_tech_unit_xp_levels_ungors	Unit experience: %+n for Ungor unit recruits	true
effects_description_wh_main_effect_ability_enable_black_periapt	Ability: "Black Periapt"	true
effects_description_wh_dlc05_effect_dummy_enable_office_the_wild_heath	Unlocks the "Herald of the Hunt" Elven Council position	true
effects_description_wh_main_effect_agent_action_success_chance_wizard_bretonnia	Hero action success chance: %+n% for Damsels	true
effects_description_wh_main_effect_agent_action_enable_dignitary_assist_province	Action: [[col:yellow]]Pray[[/col]]	true
effects_description_wh_main_effect_region_enable_chaos_attrition	Enables [[img:icon_attrition]][[/img]]attrition for non-Chaos armies	true
effects_description_wh_main_effect_force_army_battle_monster_melee_attack	Melee attack: %+n for war beasts, monstrous infantry, and Giant units	true
effects_description_wh_main_effect_ancillary_enable_rune_of_might	Grants Rune: [[col:yellow]]"Rune of Might"[[/col]]	true
effects_description_wh_main_effect_name_epithet_vmp_the_draconian	[HIDDEN] Adds the name "the Draconian"	true
effects_description_wh_main_effect_ability_enable_evasion	Passive ability: "Evasion"	true
effects_description_wh_main_effect_name_epithet_emp_the_draconian	[HIDDEN] Adds the name "the Draconian"	true
effects_description_wh_main_effect_name_epithet_dwf_the_draconian	[HIDDEN] Adds the name "the Draconian"	true
effects_description_wh_dlc05_effect_tech_melee_attack_increase_wildwood_rangers	Melee attack: %+n for Wildwood Ranger units	true
effects_description_wh_main_effect_name_epithet_chs_the_draconian	[HIDDEN] Adds the name "the Draconian"	true
effects_description_wh_main_effect_name_epithet_brt_the_draconian	[HIDDEN] Adds the name "the Draconian"	true
effects_description_wh_main_effect_force_army_battle_war_machine_armour	Armour: %+n for war machine units	true
effects_description_wh_main_effect_ability_enable_sceptre_of_stability	Ability: "Sceptre of Stability"	true
effects_description_wh_dlc03_effect_ability_enable_foe-seeker	Ability: "Foe-Seeker"	true
effects_description_wh_main_effect_magic_light_cooldown_light_of_battle	Cooldown: %+n% to "Light of Battle"	true
effects_description_wh_main_effect_agent_action_cost_mod_champion_kteb	Hero action cost: %+n% for Captains	true
effects_description_wh_main_effect_tech_upkeep_cost_reduction_irondrakes	Upkeep: %+n% for Irondrakes units	true
effects_description_wh_main_effect_magic_vampires_enable_vanhels_danse_macabre	Spell: "Vanhel's Danse Macabre"	true
effects_description_wh_main_effect_tech_recruitment_cost_reduction_gyrocopter_gyrobomber	Recruitment cost: %+n% for Gyrocopter and Gyrobomber units	true
effects_description_wh_main_effect_force_unit_stat_missile_damage	Missile damage: %+n%	true
effects_description_wh_main_effect_force_navy_battle_unit_morale_blockade	Leadership: %+n versus blockading fleets	true
effects_description_wh_dlc04_effect_magic_vampires_cooldown_invocation_of_nehek_helman	Cooldown: %+n% to "Invocation of Nehek"	true
effects_description_wh_main_effect_enable_mount_dorghar	Mount: Dorghar	true
effects_description_wh_main_effect_magic_death_enable_the_fate_of_bjuna	Spell: "The Fate of Bjuna"	true
effects_description_wh_main_effect_enable_mount_barded_nightmare	Mount: Barded Nightmare	true
effects_description_wh_main_effect_force_army_battle_melee_attack_versus_raider_armies	Melee attack: %+n versus raiding armies	true
effects_description_wh_main_effect_tech_unit_xp_levels_wraiths	Unit experience: %+n for Cairn Wraiths and Hexwraiths unit recruits	true
effects_description_wh_main_effect_magic_light_cooldown_net_of_amyntok	Cooldown: %+n% to "Net of Amyntok"	true
effects_description_wh_main_effect_tech_missile_rate_of_fire_increase_greenskin_archers	Reload time reduction: %+n% for Greenskin bow units	true
effects_description_wh_dlc03_effect_ability_enable_everbleed	Passive ability: "Everbleed"	true
effects_description_wh_main_effect_building_vampiric_mercenary_replenishment_graveguard_1	do not translate	true
effects_description_wh_main_effect_force_unit_stat_morale_own_territory	Leadership: %+n when in own or allied territory	true
effects_description_wh_main_effect_building_vampiric_mercenary_replenishment_graveguard_0	do not translate	true
effects_description_wh_main_effect_tech_melee_damage_increase_dwarf_hammer_units	Weapon strength: %+n% for Dwarf units with hammers	true
effects_description_wh_main_effect_agent_enable_recruitment_wizard_chaos	Enables [[img:icon_hero]][[/img]]Hero recruitment: Chaos Sorcerer	true
effects_description_wh_main_effect_ability_enable_seed_of_rebirth	Passive ability: "Seed of Rebirth"	true
effects_description_wh_main_effect_name_epithet_emp_wearer_of_the_chains	[HIDDEN] Adds the name "Wearer of the Chains"	true
effects_description_wh_main_effect_tech_recruitment_cost_reduction_emp_knights	Recruitment cost: %+n% for Empire Knights, Knights of the Blazing Sun, and Reiksguard units	true
effects_description_wh_main_effect_unit_equipment_armour_bronze	[Will be renamed]Armour smithing I: %+n armour for all unit recruits	true
effects_description_wh_dlc03_effect_replenishment_full	All damaged units will be fully replenished	true
effects_description_wh_main_effect_region_enable_non_vampire_territory_attrition	Enables [[img:icon_attrition]][[/img]]attrition for Undead armies	true
effects_description_wh_main_effect_force_army_campaign_recruitment_cost_trolls	Recruitment cost: %+n% for Troll units	true
effects_description_wh_dlc05_effect_amber_quest_events	Amber from Quest Battles: %n	true
effects_description_wh_main_effect_magic_death_enable_doom_and_darkness	Spell: "Doom & Darkness"	true
effects_description_wh_dlc03_effect_melee_defense_increase_characters_beastmen	Melee defence: %+n for [[img:icon_general]][[/img]]Lords and embedded [[img:icon_hero]][[/img]]Heroes	true
effects_description_wh_main_effect_tech_upkeep_cost_reduction_longbeards	Upkeep: %+n% for Longbeards units	true
effects_description_wh_main_effect_technology_research_points_mod_civil	[Will be renamed]Research rate: %+n% for civil developments	true
effects_description_wh_main_effect_force_navy_campaign_recruitment_points	Navy recruitment capacity: %+n	true
effects_description_wh_main_effect_name_epithet_chs_the_abhorrent	[HIDDEN] Adds the name "the Abhorrent"	true
effects_description_wh_main_effect_faction_mercenary_levy_can_recruit_from_local_hordes	[HIDDEN] Disable levy recruitment from hordes	true
effects_description_wh_main_effect_name_dummy_leoncoeur	[HIDDEN] Adds the name "Leoncoeur" with priority so it cannot be overridden	true
effects_description_wh_dlc05_effect_magic_shadow_cooldown_melkoths_mystifying_miasma	Cooldown: %+n% to "Melkoth's Mystifying Miasma"	true
effects_description_wh_main_effect_enable_mount_beaquis	Mount: Beaquis	true
effects_description_wh_main_effect_force_army_campaign_experience_base_cavalry	Unit experience: %+n for cavalry unit recruits	true
effects_description_wh_main_effect_agent_action_enable_all_assist_army_default	Action: [[col:yellow]]Embed Hero[[/col]]	true
effects_description_wh_main_effect_upkeep_increase_lords_hidden	Upkeep: %+n% for Lords	true
effects_description_wh_main_effect_tech_charge_speed_increase_greenskin_chariots	Charge bonus: %+n% for Greenskin Chariot units	true
effects_description_wh_main_effect_tech_missile_range_marauder_horsemen	Range: %+n% for Marauder Horsemen units	true
effects_description_wh_main_effect_tech_upkeep_cost_reduction_skeletons	Upkeep: %+n% for Skeleton Warriors and Skeleton Spearmen	true
effects_description_wh_main_effect_agent_enable_recruitment_wizard_kislev	Enables [[img:icon_hero]][[/img]]Hero recruitment: Celestial Wizard	true
effects_description_wh_dlc04_effect_magic_vampires_wind_of_death_helman	Spell: "Wind of Death"	true
effects_description_wh_dlc04_effect_unit_enable_can_siege_dummy	Attribute: Siege Attacker	true
effects_description_wh_main_effect_name_epithet_chs_the_conqueror	[HIDDEN] Adds the name "the Conqueror"	true
effects_description_wh_dlc05_effect_unit_stat_mod_ward_save_magic_wef	Magic resistance: %n% for all units	true
effects_description_wh_main_effect_building_vampiric_mercenary_replenishment_dire_wolves	do not translate	true
effects_description_wh_main_effect_tech_battle_morale_increase_lords_and_heroes	Leadership: %+n for [[img:icon_general]][[/img]]Lords and embedded [[img:icon_hero]][[/img]]Heroes	true
effects_description_wh_main_effect_tech_unit_xp_levels_big_uns	Unit experience: %+n for Big 'Uns unit recruits	true
effects_description_wh_main_effect_force_army_battle_dwf_tier_2_missile_damage	Missile damage: %+n% for Irondrakes, Cannon, Flame Cannon and Organ Gun units	true
effects_description_wh_main_effect_force_army_campaign_siege_defend_holdout_time_hidden	[HIDDEN] Adds 2 turns of siege holdout time to province capitals	true
effects_description_wh_main_effect_ability_enable_faiths_bastion	Ability: "Faith's Bastion"	true
effects_description_wh_main_effect_tech_recruitment_cost_reduction_chaos_warriors_chosen	Recruitment cost: %+n% for Chaos Knights and Chosen units	true
effects_description_wh_dlc05_effect_magic_shadow_pit_of_shades	Spell: "Pit of Shades"	true
effects_description_wh_main_effect_faction_mercenary_levy_units_per_region_mod	[HIDDEN] Disable levy recruitment	true
effects_description_wh_main_effect_force_unit_stat_melee_damage	Weapon strength: %+n%	true
effects_description_wh_dlc03_effect_spell_buff	Cooldown: %+n% to all spells of the [[img:icon_hero]][[/img]]Hero and accompanying [[img:icon_general]][[/img]]Lord	true
effects_description_wh_main_effect_agent_action_enable_champion_hinder_settlement	Action: [[col:yellow]]Assault Garrison[[/col]]	true
effects_description_wh_main_effect_force_all_campaign_stance_cannot_recruit_dummy	[[col:red]]Recruitment: Disabled[[/col]]	true
effects_description_wh_main_effect_ability_enable_pidgeon_plucker_pendant	Passive ability: "Pidgeon Plucker Pendant"	true
effects_description_wh_main_effect_force_army_campaign_upkeep_cost_melee_infantry	Upkeep: %+n% for melee infantry units	true
effects_description_wh_main_effect_unit_equipment_weapon_bronze	[Will be renamed]Weaponsmithing I: %+n% melee damage for all unit recruits	true
effects_description_wh_main_effect_public_order_osmosis	{{tr:public_order}}: %+n in your adjacent provinces	true
effects_description_wh_main_effect_force_unit_stat_melee_attack	Melee attack: %+n	true
effects_description_wh_main_effect_ability_enable_rally	Ability: "Rally"	true
effects_description_wh_dlc03_hero_passive_offensive_aura_unit_ability_disable_1	Replaces: "The Unrelenting Herd  I"	true
effects_description_wh_dlc03_hero_passive_offensive_aura_unit_ability_disable_2	Replaces: "The Unrelenting Herd  II"	true
effects_description_wh_dlc03_hero_passive_offensive_aura_unit_ability_disable_3	Replaces: "The Unrelenting Herd III"	true
effects_description_wh_main_effect_magic_fire_cooldown_fireball	Cooldown: %+n% to "Fireball"	true
effects_description_wh_dlc03_hero_passive_defensive_aura_unit_ability_disable_3	Replaces: "The Strength of the Land III"	true
effects_description_wh_dlc03_hero_passive_defensive_aura_unit_ability_disable_2	Replaces: "The Strength of the Land II"	true
effects_description_wh_dlc03_hero_passive_defensive_aura_unit_ability_disable_1	Replaces: "The Strength of the Land I"	true
effects_description_wh_main_effect_name_epithet_emp_the_officious	[HIDDEN] Adds the name "the Officious"	true
effects_description_wh_main_effect_tech_missile_range_rock_lobber	Range: %+n% for Goblin Rock Lobber units	true
effects_description_wh_dlc03_effect_building_upkeep_reduction_minotaurs	Upkeep: %+n% for Minotaur units	true
effects_description_wh_main_effect_ability_enable_master_rune_of_slowness	Passive ability: "Rune of Slowness"	true
effects_description_wh_main_effect_ability_enable_master_rune_of_stoicism	Ability: "Rune of Stoicism"	true
effects_description_wh_dlc03_effect_building_upkeep_reduction_razorgors	Upkeep: %+n% for Razorgor Herd units	true
effects_description_wh_main_effect_ability_enable_immortal_will	Ability: "Immortal Will"	true
effects_description_wh_main_effect_magic_lil_waaagh_enable_gorkll_fix_it	Spell: "Gork'll Fix It"	true
effects_description_wh_dlc05_effect_tech_missile_damage_increase_glade_guards	Missile damage: %+n% for Glade Guard units	true
effects_description_wh_main_effect_name_epithet_grn_da_bossy_git	[HIDDEN] Adds the name "Da Bossy Git"	true
effects_description_wh_main_effect_skill_charge_bonus_increase_vmp_tier_2	Charge bonus: %+n for Grave Guard and Crypt Horrors units	true
effects_description_wh_main_effect_skill_charge_bonus_increase_vmp_tier_1	Charge bonus: %+n for Zombies, Skeletons and Crypt Ghouls units	true
effects_description_wh_dlc03_effect_ability_disable_blood_lust	Replaces: "Blood Lust"	true
effects_description_wh_main_effect_tech_upkeep_cost_reduction_hammerers	Upkeep: %+n% for Hammerers units	true
effects_description_wh_main_effect_ability_enable_hold_the_line	Passive ability: "Hold the Line!"	true
effects_description_wh_main_effect_religion_undeath_public_order	{{tr:public_order}}: Up to %+n, based on the percentage of [[img:icon_corruption_vmp]][[/img]]Vampiric corruption present	true
effects_description_wh_dlc03_effect_ability_enable_trollhide	Passive ability: "Trollhide"	true
effects_description_wh_main_effect_siege_tower_missile_attack_rate_own	Reload time reduction: %+n% for towers in siege battles	true
effects_description_wh_main_effect_tech_unit_xp_levels_thunderers	Unit experience: %+n for Thunderers unit recruits	true
effects_description_wh_main_effect_tech_melee_defence_increase_dwarf_shield_units	Melee defence: %+n for Dwarf shield units	true
effects_description_wh_main_effect_region_resource_gem_production	Gemstones resource production: %n sacks	true
effects_description_wh_main_effect_force_navy_battle_artillery_ship_missile_range	Range: %+n% for artillery ships	true
effects_description_wh_main_effect_name_epithet_brt_the_oppressor	[HIDDEN] Adds the name "the Oppressor"	true
effects_description_wh_main_effect_name_epithet_chs_the_oppressor	[HIDDEN] Adds the name "the Oppressor"	true
effects_description_wh_main_effect_name_epithet_dwf_the_oppressor	[HIDDEN] Adds the name "the Oppressor"	true
effects_description_wh_main_effect_name_epithet_emp_the_oppressor	[HIDDEN] Adds the name "the Oppressor"	true
effects_description_wh_main_effect_name_epithet_grn_the_oppressor	[HIDDEN] Adds the name "the Oppressor"	true
effects_description_wh_main_effect_ability_enable_life-leeching	Passive ability: "Life-Leeching"	true
effects_description_wh_main_effect_tech_missile_range_increase_irondrakes	Range: %+n% for Irondrakes units	true
effects_description_wh_main_effect_name_epithet_vmp_the_oppressor	[HIDDEN] Adds the name "the Oppressor"	true
effects_description_wh_main_effect_name_epithet_dwf_the_dauntless	[HIDDEN] Adds the name "the Dauntless"	true
effects_description_wh_main_effect_force_army_battle_armour_all	Armour: %+n for all units	true
effects_description_wh_dlc03_effect_building_upkeep_reduction_beastmen_giants	Upkeep: %+n% for Giants	true
effects_description_wh_main_effect_enable_mount_pegasus	Mount: Pegasus	true
effects_description_wh_main_effect_agent_action_outcome_local_province_recruitment_cost	Recruitment cost: %+n%	true
effects_description_wh_main_effect_force_newhorde_buildings_savage_orcs	[HIDDEN] Building set used when a new Savage Orc horde spawns	true
effects_description_wh_main_effect_magic_light_enable_shems_burning_gaze	Spell: "Shem's Burning Gaze"	true
effects_description_wh_main_effect_agent_enable_recruitment_wizard_greenskins_orc_shaman	Enables [[img:icon_hero]][[/img]]Hero recruitment: Orc Shaman	true
effects_description_wh_dlc05_effect_ability_enable_daiths_sword	Ability: "Sword of Daith"	true
effects_description_wh_main_effect_force_army_campaign_recruitment_points	Global recruitment capacity: %+n	true
effects_description_wh_dlc05_effect_force_army_campaign_upkeep_cost_wild_riders	Upkeep and Recruitment cost: %+n% for Wild Riders units	true
effects_description_wh_main_effect_force_all_campaign_raid_income	Income from raiding: %+n%	true
effects_description_wh_main_effect_character_stat_mod_personal_aura_size	Aura size: %+n%	true
effects_description_wh_dlc03_effect_ability_enable_slug_skin	Passive ability: "Slug-Skin"	true
effects_description_wh_main_effect_magic_vampires_enable_wind_of_death	Spell: "Wind of Death"	true
effects_description_wh_main_effect_magic_fire_cooldown_piercing_bolts_of_burning	Cooldown: %+n% to "Piercing Bolts of Burning"	true
effects_description_wh_dlc05_effect_ability_enable_passive_melee_aura_2	Passive ability: "Howl of the Forest"	true
effects_description_wh_dlc05_effect_ability_enable_passive_melee_aura_1	Passive ability: "Call of the Woods"	true
effects_description_wh_main_effect_force_army_battle_infantry_missile_firing_rate	Reload time reduction: %+n% for missile infantry units	true
effects_description_wh_main_effect_ability_enable_van_horstmanns_speculum	Ability: "Van Horstmann's Speculum"	true
effects_description_wh_main_effect_ability_enable_gitsnik	Ability: "Gitsnik"	true
effects_description_wh_main_effect_agent_cap_increase_spy_banshee	Banshee [[img:icon_hero]][[/img]]Hero capacity: %+n	true
effects_description_wh_main_effect_technology_research_points_mod	Research rate: %+n%	true
effects_description_wh_main_effect_tech_melee_damage_increase_skeleton_warriors_spears	Weapon strength: %+n% for Skeleton Warriors and Skeleton Spearmen	true
effects_description_wh_main_effect_force_army_battle_pistoliers_outriders_charge_bonus	Charge bonus: %+n for Pistoliers and Outriders units	true
effects_description_wh_dlc05_effect_ability_enable_blessed_by_the_mage_queen	Passive Ability: "Blessed by the Mage Queen"	true
effects_description_wh_main_effect_ability_enable_forbidden_rod	Ability: "Forbidden Rod"	true
effects_description_wh_main_effect_ability_enable_sneaky_stealin	Passive ability: "Sneaky Stealin'"	true
effects_description_wh_main_effect_magic_death_enable_aspect_of_the_dreadknight	Spell: "Aspect of the Dread Knight"	true
effects_description_wh_main_effect_force_unit_stat_morale_undead	Leadership: %+n for Undead units	true
effects_description_wh_dlc03_effect_agent_cap_increase_wizard_beastmen	Bray-Shaman [[img:icon_hero]][[/img]]Hero capacity: %+n	true
effects_description_wh_main_effect_agent_enable_recruitment_wizard_vampire_counts	Enables [[img:icon_hero]][[/img]]Hero recruitment: Necromancer	true
effects_description_wh_main_effect_name_epithet_emp_the_emperors_champion	[HIDDEN] Adds the name "the Emperor's Champion"	true
effects_description_wh_dlc05_effect_magic_shadow_cooldown_the_withering	Cooldown: %+n% to "The Withering"	true
effects_description_wh_main_effect_tech_recruitment_cost_reduction_chaos_warriors	Recruitment cost: %+n% for Chaos Warrior and Aspiring Champion units	true
effects_description_wh_dlc05_effect_magic_shadow_enfeebling_foe	Spell: "The Enfeebling Foe"	true
effects_description_wh_main_effect_ability_enable_banner_of_rage	Passive ability: "Banner of Rage"	true
effects_description_wh_main_effect_agent_action_success_chance_champion_vampire_counts	Hero action success chance: %+n% for Wight Kings	true
effects_description_wh_main_effect_economy_gdp_mod_commerce_land	[Will be renamed]Wealth: %+n% from commerce	true
effects_description_wh_main_effect_tech_unit_xp_levels_goblins	Unit experience: %+n for Goblin and Night Goblin unit recruits	true
effects_description_wh_main_effect_conquest_enable_night_battles	Enables lightning strike battles when reinforcements are present	true
effects_description_wh_main_effect_conquest_resistance_to_occupation_mod	Resistance to occupation: %+n%	true
effects_description_wh_main_effect_ability_enable_griffon_banner	Passive ability: "Griffon Banner"	true
effects_description_wh_dlc04_effect_enable_mount_corpse_cart_balefire	Mount: Corpse Cart with Balefire	true
effects_description_wh_main_effect_magic_big_waaagh_enable_fists_of_gork	Spell: "Fists of Gork"	true
effects_description_wh_main_effect_force_army_campaign_attrition_swamp_resistance	Attrition: %+n% casualties suffered from swamp attrition	true
effects_description_wh_main_effect_politics_political_event_occurence_mod	Political incidents: %+n% chance of occuring	true
effects_description_wh_dlc04_effect_enable_mount_corpse_cart_lodestone	Mount: Corpse Cart with Unholy Lodestone	true
effects_description_wh_main_effect_force_army_campaign_stance_tunnelling_retreat_dummy	Should the army be intercepted, retreat will be impossible. If it loses the battle it will be wiped out.	true
effects_description_wh_dlc05_effect_tech_charge_speed_increase_dryads	Charge bonus: %+n% for Dryad units	true
effects_description_wh_main_effect_agent_cap_increase_runesmith	Runesmith [[img:icon_hero]][[/img]]Hero capacity: %+n	true
effects_description_wh_main_effect_public_order_characters_dummy	{{tr:public_order}}: %+n	true
effects_description_wh_dlc05_effect_tech_battle_morale_increase_spellsingers	Leadership: %+n for embedded Spellsinger [[img:icon_hero]][[/img]]Heroes	true
effects_description_wh_dlc03_effect_ability_enable_axe_of_men	Ability: "Axe of Men"	true
effects_description_wh_dlc03_effect_force_newhorde_building_beastmen	[HIDDEN] Building set used when a new Beastmen horde spawns	true
effects_description_wh_main_effect_force_all_campaign_replenishment_rate_chaos	Casualty replenishment rate: %+n% for Chaos units	true
effects_description_wh_main_effect_agent_action_enable_dignitary_hinder_province	Action: [[col:yellow]]Inhibit[[/col]]	true
effects_description_wh_dlc04_effect_magic_vampires_cooldown_raise_dead_helman	Cooldown: %+n% to "Awaken from the Grave"	true
effects_description_wh_main_effect_military_force_winds_of_magic_depletion_mod_character	Winds of Magic power reserve: %+n	true
effects_description_wh_main_effect_magic_metal_cooldown_plague_of_rust	Cooldown: %+n% to "Plague of Rust"	true
effects_description_wh_main_effect_character_stat_mod_unit_health	Hit Points: %+n%	true
effects_description_wh_main_effect_agent_action_success_chance_wizard_teb	Hero action success chance: %+n% for Bright Wizards	true
effects_description_wh_main_effect_agent_defence_wound_chance_mod	Hero self-defence: %+n% chance of wounding aggressors	true
effects_description_wh_main_effect_character_passive_religious_conversion	[HIDDEN] Corruption from character presence: %+n	true
effects_description_wh_dlc05_effect_agent_action_cost_mod_champion_wood_elves	Hero action cost: %+n% for Branchwraiths	true
effects_description_wh_main_effect_ability_enable_axe_of_dargo	Ability: "Axe of Dargo"	true
effects_description_wh_main_effect_krell_dummy	In battle, Kemmler can call upon Krell, a powerful Hero, with a unique summoning ability	true
effects_description_wh_dlc04_effect_tech_upkeep_reduction_flagellants	Upkeep: %+n% for Flagellant units	true
effects_description_wh_main_effect_tech_armour_increase_infantry	Armour: %+n for infantry units	true
effects_description_wh_main_effect_force_army_battle_artillery_ranged_ammunition	Ammunition: %+n% for artillery	true
effects_description_wh_dlc03_effect_ability_enable_mangelder	Passive ability: "Mangelder"	true
effects_description_wh_dlc05_effect_force_army_campaign_stance_tunnelling_interception_dummy_wood_elves	Nearby hostile armies may intercept this force within the Worldroots.	true
effects_description_wh_main_effect_ability_enable_banner_of_eternal_flame	Passive ability: "Banner of Eternal Flame"	true
effects_description_wh_main_effect_tech_unit_xp_levels_knights_demigryphs	Unit experience: %+n for Empire Knights, Reiksguard, Knights of the Blazing Sun, and Demigryph unit recruits	true
effects_description_wh_dlc05_effect_tech_army_campaign_worldroot_evasion_chance	Evasion chance when using the Worldroots: %+n%	true
effects_description_wh_main_effect_tech_recruitment_cost_reduction_miners	Recruitment cost: %+n% for Miners units	true
effects_description_wh_main_effect_tech_unit_xp_levels_emp_swords_knights	Unit experience: %+n for Empire Swordsmen and Greatsword unit recruits	true
effects_description_wh_main_effect_tech_unit_xp_levels_irondrakes	Unit experience: %+n for Irondrakes unit recruits	true
effects_description_wh_main_effect_general_mod_tunnel_interception_chance	Chance of intercepting an army using the Underway, beast-paths or Worldroots: %+n%	true
effects_description_wh_main_effect_agent_enable_recruitment_champion_kteb	Enables [[img:icon_hero]][[/img]]Hero recruitment: Captain	true
effects_description_wh_dlc05_effect_magic_life_enable_regrowth	Spell: "Regrowth"	true
effects_description_wh_main_effect_force_all_campaign_replenishment_rate_undead	Casualty replenishment rate: %+n% for Undead units	true
effects_description_wh_dlc05_effect_ability_disable_the_eye_of_kurnous	Replaces: "The Eye of Kurnous"	true
effects_description_wh_main_effect_public_order_difficulty_level	{{tr:public_order}}: %+n {{tr:public_order}} from campaign difficulty level	true
effects_description_wh_main_effect_agent_action_cost_mod_champion_chaos	Hero action cost: %+n% for Exalted Heroes	true
effects_description_wh_dlc03_effect_bloodlust_modifier_peace	Bestial rage: %+n from peaceful diplomacy	true
effects_description_wh_dlc04_effect_magic_vampires_enable_invocation_of_nehek_strigoi	Spell: "Invocation of Nehek"	true
effects_description_wh_main_effect_character_stat_mod_morale_not_shown	Leadership: %+n 	true
effects_description_wh_main_effect_ability_enable_arcane_conduit	Ability: "Arcane Conduit"	true
effects_description_wh_dlc05_effect_faction_global_recruitment_points_building	Recruitment capacity: %+n	true
effects_description_wh_dlc05_effect_ability_enable_hail_of_doom_arrow	Ability: "Hail of Doom Arrow"	true
effects_description_wh_dlc05_effect_tech_missile_range_increase_glade_guards	Range: %+n% for Glade Guard units	true
effects_description_wh_main_effect_tech_recruitment_cost_reduction_dragon_ogres	Recruitment cost: %+n% for Dragon Ogre units	true
effects_description_wh_main_effect_skill_ammunition_increase_dwf_tier_1	Ammunition: %+n% for Quarrellers, Thunderers and Grudge Thrower units	true
effects_description_wh_main_effect_agent_action_champion_assist_army_buff	[[col:yellow]]Training[[/col]] action: Experience per turn is increased by an additional %n	true
effects_description_wh_main_effect_force_all_campaign_experience_base_all	Unit experience: %+n for all unit recruits	true
effects_description_wh_main_effect_tech_charge_speed_increase_black_coach	Charge bonus: %+n% for Black Coach, Corpse Cart, and Mortis Engine units	true
effects_description_wh_main_effect_agent_action_enable_dignitary_hinder_character	Action: [[col:yellow]]Assassinate[[/col]]	true
effects_description_wh_main_effect_name_epithet_vmp_lord_of_dark_whispers	[HIDDEN] Adds the name "Lord of Dark Whispers"	true
effects_description_wh_dlc05_effect_tech_recruitment_cost_reduction_wef_cavalry	Recruitment cost: %+n% for Elf cavalry units	true
effects_description_wh_main_effect_force_all_campaign_loot_income	Income from looting settlements: %+n%	true
effects_description_wh_main_effect_character_stat_mod_ward_save_physical	Physical resistance: %n%	true
effects_description_wh_main_effect_agent_cap_increase_wizard_orc_shaman	Shaman [[img:icon_hero]][[/img]]Hero capacity: %+n	true
effects_description_wh_main_effect_force_navy_battle_assault_ship_melee_attack	Melee attack: %+n for melee ships	true
effects_description_wh_main_effect_agent_action_enable_spy_assist_army	Action: [[col:yellow]]Guard[[/col]]	true
effects_description_wh_dlc03_effect_bloodlust_modifier	Bestial rage: %+n	true
effects_description_wh_dlc04_effect_force_all_campaign_loot_income_not_shown	Income from looting settlements: %+n%	true
effects_description_wh_main_effect_agent_action_enable_runesmith_hinder_province	Action: [[col:yellow]]Runic Protection[[/col]]	true
effects_description_wh_dlc05_effect_magic_life_cooldown_awakening_of_the_wood	Cooldown: %+n% to "Awakening of the Wood"	true
effects_description_wh_main_effect_tech_unit_xp_levels_longbeards	Unit experience: %+n for Longbeards unit recruits	true
effects_description_wh_main_effect_name_epithet_chs_the_despoiler	[HIDDEN] Adds the name "the Despoiler"	true
effects_description_wh_main_effect_name_epithet_brt_the_despoiler	[HIDDEN] Adds the name "the Despoiler"	true
effects_description_wh_main_effect_name_epithet_emp_the_despoiler	[HIDDEN] Adds the name "the Despoiler"	true
effects_description_wh_main_effect_name_epithet_grn_the_despoiler	[HIDDEN] Adds the name "the Despoiler"	true
effects_description_wh_main_effect_tech_unit_xp_levels_black_orcs	Unit experience: %+n for Black Orc unit recruits	true
effects_description_wh_main_effect_name_epithet_vmp_the_despoiler	[HIDDEN] Adds the name "the Despoiler"	true
effects_description_wh_main_effect_agent_action_wizard_hinder_army_buff	[[col:yellow]]Assault Unit[[/col]] action: Additional %n% damage caused	true
effects_description_wh_main_effect_force_navy_battle_melee_attack_versus_raider_fleets	Melee attack: %+n versus raiding fleets	true
effects_description_wh_main_effect_tech_recruitment_cost_reduction_quarrellers	Recruitment cost: %+n% for Quarrellers units	true
effects_description_wh_main_effect_force_navy_battle_assault_ship_melee_damage	Weapon strength: %+n% for melee ships	true
effects_description_wh_main_effect_magic_light_enable_bironas_timewarp	Spell: "Birona's Timewarp"	true
effects_description_wh_main_effect_faction_confederation_dummy	[[col:yellow]]Further [[img:icon_confederation]][[/img]]confederations will not be possible while this is in effect.[[/col]]	true
effects_description_wh_main_effect_agent_enable_recruitment_spy_vampire_counts	Enables [[img:icon_hero]][[/img]]Hero recruitment: Banshee	true
effects_description_wh_dlc05_effect_tech_upkeep_reduction_treespirits	Upkeep: %+n% for forest spirit units	true
effects_description_wh_main_effect_tech_movement_speed_empire_infantry	Speed: %+n% for Empire infantry units	true
effects_description_wh_main_effect_ability_enable_metalshifting	Passive ability: "Metalshifting"	true
effects_description_wh_main_effect_building_upkeep_reduction_chaos_dragon_ogre	Upkeep: %+n% for Dragon Ogres and Dragon Ogre Shaggoths	true
effects_description_wh_main_effect_tech_unit_xp_levels_skeletons	Unit experience: %+n for Skeletal and Zombies unit recruits	true
effects_description_wh_main_effect_force_army_battle_cavalry_heavy_melee_attack	Melee attack: %+n for heavy cavalry units	true
effects_description_wh_dlc03_effect_magic_wild_cooldown_devolve	Cooldown: %+n% to "Devolve"	true
effects_description_wh_main_effect_agent_action_success_chance_spy_empire	Hero action success chance: %+n% for Witch Hunters	true
effects_description_wh_main_effect_agent_action_success_chance_champion_dwarfs	Hero action success chance: %+n% for Thanes	true
effects_description_wh_main_effect_politics_political_action_political_support_cost_mod	Political action cost: %+n% political support	true
effects_description_wh_main_effect_unit_enable_attribute_strider	Attribute: Strider	true
effects_description_wh_main_effect_agent_action_cost_mod_wizard_empire	Hero action cost: %+n% for Wizards	true
effects_description_wh_dlc04_effect_magic_vampires_enable_raise_dead_strigoi	Spell: "Command of the Unliving"	true
effects_description_wh_dlc05_effect_magic_life_enable_earth_blood_branchwraith	Spell: "Earth Blood"	true
effects_description_wh_main_effect_building_vampiric_mercenary_capacity_varghulf	do not translate	true
effects_description_wh_dlc04_effect_enable_mount_corpse_cart	Mount: Corpse Cart	true
effects_description_wh_main_effect_force_army_campaign_attrition_snow_resistance	Attrition: %+n% casualties suffered from snow attrition	true
effects_description_wh_main_effect_force_all_campaign_replenishment_rate_horde	Casualty replenishment rate: %+n%	true
effects_description_wh_dlc05_effect_tech_hero_xp_levels_branchwraiths	Hero recruit rank: %+n for Branchwraiths	true
effects_description_wh_dlc05_effect_dummy_enable_office_ancient_of_threllock	Unlocks the "Ancient of Threllock" position within the Gathering of the Ancients	true
effects_description_wh_main_effect_tech_upkeep_reduction_wraiths	Upkeep: %+n% for Cairn Wraiths and Hexwraiths units	true
effects_description_wh_main_effect_tech_melee_damage_increase_fanatics	Weapon strength: %+n% for Night Goblin (Fanatics) units	true
effects_description_wh_main_effect_agent_action_success_chance_runesmith	Hero action success chance: %+n% for Runesmiths	true
effects_description_wh_main_effect_tech_armour_increase_dwarf_characters	Armour: %+n for [[img:icon_general]][[/img]]Lords and embedded [[img:icon_hero]][[/img]]Heroes	true
effects_description_wh_dlc03_effect_tech_recruitment_cost_reduction_centigors	Recruitment cost: %+n% for Centigor units	true
effects_description_wh_dlc03_effect_tech_recruitment_cost_reduction_bestigors	Recruitment cost: %+n% for Bestigor units	true
effects_description_wh_dlc03_hero_passive_defensive_aura_unit_ability_enable_4	Ability: "The Strength of the Land IV"	true
effects_description_wh_dlc03_hero_passive_offensive_aura_unit_ability_enable_4	Passive ability: "The Unrelenting Herd IV"	true
effects_description_wh_dlc03_hero_passive_defensive_aura_unit_ability_enable_1	Ability: "The Strength of the Land I"	true
effects_description_wh_dlc03_hero_passive_offensive_aura_unit_ability_enable_1	Passive ability: "The Unrelenting Herd I"	true
effects_description_wh_main_effect_force_unit_stat_armour	Armour: %+n	true
effects_description_wh_dlc03_hero_passive_defensive_aura_unit_ability_enable_3	Ability: "The Strength of the Land III"	true
effects_description_wh_dlc03_hero_passive_offensive_aura_unit_ability_enable_3	Passive ability: "The Unrelenting Herd III"	true
effects_description_wh_dlc03_hero_passive_defensive_aura_unit_ability_enable_2	Ability: "The Strength of the Land II"	true
effects_description_wh_dlc03_hero_passive_offensive_aura_unit_ability_enable_2	Passive ability: "The Unrelenting Herd II"	true
effects_description_wh_main_effect_force_army_battle_cavalry_melee_damage	Weapon strength: %+n% for cavalry units	true
effects_description_wh_main_effect_force_army_battle_flying_charge_bonus	Charge bonus: %+n% for Vargheists and Terrorgheist units	true
effects_description_wh_main_effect_agent_action_assassinate_success_chance_enemy	[HIDDEN] Enemy Hero assassinate success chance: %+n%	true
effects_description_wh_main_effect_tech_movement_speed_increase_ghouls_horrors	Speed: %+n% for Crypt Ghoul and Crypt Horror units	true
effects_description_wh_main_effect_tech_recruitment_cost_reduction_savage_orcs	Recruitment cost: %+n% for Savage Orc units	true
effects_description_wh_main_effect_ability_enable_master_rune_of_grungni	Passive ability: "Master Rune of Grungni"	true
effects_description_wh_main_effect_agent_recruitment_cost_mod_champion_bretonnia	Hero recruitment cost: %+n% for Paladins	true
effects_description_wh_main_effect_magic_fire_cooldown_the_burning_head	Cooldown: %+n% to "The Burning Head"	true
effects_description_wh_main_effect_ability_enable_spider_banner	Passive ability: "Spider Banner"	true
effects_description_wh_main_effect_force_army_campaign_siege_defend_holdout_time	Siege holdout time: %+n	true
effects_description_wh_dlc04_effect_force_all_campaign_razing_income_not_shown	Income from razing settlements: %+n%	true
effects_description_wh_main_effect_force_army_battle_cavalry_melee_attack	Melee attack: %+n for cavalry units	true
effects_description_wh_main_effect_agent_action_engineer_hinder_army_buff	[[col:yellow]]Sabotage[[/col]] action: Movement range is modified by an additional %n%	true
effects_description_wh_main_effect_force_all_campaign_post_battle_loot_mod_hidden	[HIDDEN]	true
effects_description_wh_main_effect_force_army_campaign_local_happiness_repression	{{tr:public_order}}: %+n from military presence	true
effects_description_wh_main_effect_name_epithet_emp_the_disturbed	[HIDDEN] Adds the name "the Disturbed"	true
effects_description_wh_main_effect_name_epithet_dwf_the_disturbed	[HIDDEN] Adds the name "the Disturbed"	true
effects_description_wh_main_effect_name_epithet_grn_the_disturbed	[HIDDEN] Adds the name "the Disturbed"	true
effects_description_wh_main_effect_name_epithet_chs_the_disturbed	[HIDDEN] Adds the name "the Disturbed"	true
effects_description_wh_main_effect_name_epithet_brt_the_disturbed	[HIDDEN] Adds the name "the Disturbed"	true
effects_description_wh_main_effect_force_army_battle_dwf_tier_2_ammo	Ammunition: %+n% for Irondrakes, Cannon, Flame Cannon and Organ Gun units	true
effects_description_wh_main_effect_name_epithet_vmp_the_disturbed	[HIDDEN] Adds the name "the Disturbed"	true
effects_description_wh_main_effect_force_campaign_stance_begin_fatigued_3_winded	Vigour in battle: Winded	true
effects_description_wh_main_effect_agent_action_spy_hinder_province_buff	[[col:yellow]]Infiltrate[[/col]] action: Income is modified by an additional %n%	true
effects_description_wh_main_effect_force_army_battle_unit_morale_during_forest	Leadership: %+n during forest battles	true
effects_description_wh_main_effect_force_navy_battle_support_ship_missile_range	Range: %+n% for missile ships	true
effects_description_wh_main_effect_agent_action_success_chance	Hero action success chance: %+n%	true
effects_description_wh_main_effect_modify_vassal_income	Tribute from Vassals: %+n%	true
effects_description_wh_main_faction_diplomacy_penalty_greenskins	Diplomatic relations: %+n with Greenskin Tribes	true
effects_description_wh_main_effect_tech_melee_damage_increase_greenskin_spears	Weapon strength: %+n% for Greenskin units with spears	true
effects_description_wh_main_effect_unit_equipment_weapon_silver	[Will be renamed]Weaponsmithing II: %+n% melee damage for all unit recruits	true
effects_description_wh_main_effect_battle_magic_lil_waaagh_cooldown_rate	Cooldown: %+n% to Little Waaagh! spells	true
effects_description_wh_main_effect_force_army_campaign_attrition_all_resistance	Attrition: %+n% casualties suffered from all attrition	true
effects_description_EMPTY_EFFECT	((EMPTY EFFECT))	true
